Thursday night. Thursday, a concept that means very little to the recently deceased, which you most certainly are; and night, which as it turns out, is quickly becoming your favourite part of whole night-day dichotomy.

Haunting is on the cards for this particular evening. The supernatural, as it happens, is perfectly natural - common even. You've chosen a typical suburban house inhabited by a small family for the occasion. Your aim - confuse them, creep them out and scare them silly!

You're still new to this whole possession malarky, but an undead buddy of yours has kindly agreed to come along to offer pointers here and there. He said he'd meet you there.

Hint: To possess an item, try '>haunt the window' or '>haunt the lamp'.

Landing
A framed family photo hangs on the wall. "The illusion of permanence" you think to yourself. A wooden door leads in to the child's bedroom. The hallway itself continues south from here and while there is a staircase leading down to the first floor, all the fun (read horror) is up here.

You can see a ball here.

Scaring 101
An Interactive Fiction by Mikrokosmonaut
Release 1 / Serial number 181205 / Inform 7 build 6M62 (I6/v6.33 lib 6/12N) SD

Landing
A framed family photo hangs on the wall. A wooden door leads in to the child's bedroom. The hallway itself continues south from here and while there is a staircase leading down to the first floor, all the fun is up here.

You can see a ball here.

>x bed
You see nothing special about the small bed.

>x mattress
You see nothing special about the small bed's mattress.

>x pillow
You see nothing special about the small bed's pillow.

* * *

>test me
(Testing.)

>[1] haunt bed
As you haunt the child's bed, it starts to shake back and forth.

>[2] haunt mattress
You can't haunt the mattress.

>x pillows
You see nothing special about the pillows.

>x bed
You see nothing special about the child's bed.

* * *

>haunt bed
As you haunt the child's bed, it starts to shake back and forth.

The young boy wakes up not quite sure of what's going on. The teddy bear immediately collapses to the floor to avoid being noticed. 

[Your score has just gone up by one point.]

>haunt pillows
You can't haunt the pillows.

>haunt boy
You can't haunt the boy.

* * *

>haunt bed
As you haunt the child's bed, it starts to shake back and forth.

The young boy wakes up not quite sure of what's going on. The teddy bear immediately collapses to the floor to avoid being noticed. 

[Your score has just gone up by one point.]

>haunt bed
As you haunt the child's bed, it starts to shake back and forth.

The young boy screams. The young boy gets out of the child's bed.

The young boy goes to the Landing, looking fairly scared.

[Your score has just gone up by one point.]

I beg your pardon?

* * *

>haunt bed
As you haunt the child's bed, it starts to shake back and forth.

The young boy screams. The young boy gets out of the child's bed.

The young boy goes to the Landing, looking fairly scared.

[Your score has just gone up by one point.]

>haunt bed
As you haunt the child's bed, it starts to shake back and forth.

The young boy jumps with fright. The young boy screams.

>haunt bed
As you haunt the child's bed, it starts to shake back and forth.

The young boy jumps with fright. The young boy screams.

* * *

>haunt bed
As you haunt the child's bed, it starts to shake back and forth.

The young boy wakes up not quite sure of what's going on. The teddy bear immediately collapses to the floor to avoid being noticed. 

[Your score has just gone up by one point.]

>haunt lamp
You can't haunt the lamp.

* * *

>x young boy
You see nothing special about the young boy.

>haunt door
The wooden door starts to rattle.

The young boy wakes up wondering what is going on.

Someone has woken up.

* * *

>haunt mattress
You can't haunt the mattress.

>haunt bed
As you haunt the child's bed, it starts to shake back and forth.

The young boy wakes up with a start.

Someone has woken up.

>look
Child's Bedroom
You can see the child's bed (in which is a scared young boy) here.

* * *

>take bed
You're a poltergeist. You're not in the business of 'taking'.

>eat bed
You're a poltergeist. You're not in the business of 'eating'.

>haunt bed
As you haunt the child's bed, it starts to shake back and forth.

The young boy wakes up with a start.

Someone has woken up.

* * *

>n
You shimmer through to the Landing.

Landing
A framed family photo hangs on the wall. "The illusion of permanence" you think to yourself. A wooden door leads in to the child's bedroom. The hallway itself continues south from here and while there is a staircase leading down to the first floor, all the fun (read horror) is up here.

You can see a ball here.

The teddy bear waddles in from the Child's Bedroom.

>n
You can't go that way.

>s
Child's Bedroom
You can see the child's bed (in which is a sleeping young boy) and a teddy bear here.

>s
You can't go that way.

>n
Hall

>z
You're a poltergeist. You're not in the business of waiting.

>z
You're a poltergeist. You're not in the business of waiting.

>look
Hall

>look
Hall

* * *

>n
You shimmer through to the Landing.

Landing
A framed family photo hangs on the wall. "The illusion of permanence" you think to yourself. A wooden door leads in to the child's bedroom. The hallway itself continues south from here and while there is a staircase leading down to the first floor, all the fun (read horror) is up here.

You can see a ball here.

The teddy bear waddles in from the Child's Bedroom.

>z
Time passes.

>z
Time passes.

Keep in mind rule #1: Consider your surroundings

>z
Time passes.

>look
Hall

* * *

>z
Time passes.

>z
Time passes.

* * *

>look
Hall

>x
What do you want to examine?

>s
You see nothing unexpected in that direction.

>n
You can't go that way.

* * *

>n
You shimmer through to the Landing.

Landing
A framed family photo hangs on the wall. "The illusion of permanence" you think to yourself. A wooden door leads in to the child's bedroom. The hallway itself continues south from here and while there is a staircase leading down to the first floor, all the fun (read horror) is up here.

You can see a ball here.

The teddy bear waddles in from the Child's Bedroom.

>haunt ball
Out of nowhere the ball bounces off towards the Hall.

>look
Landing
You can see a teddy bear and a wooden door here.

>s
You shimmer through to the Hallway.

Hallway
You can see a ball, a bedroom door, a mirror and a radio here.

The teddy bear arrives from the north.

>haunt ball
Out of nowhere the ball bounces off towards the Landing.

>haunt ball
You can't see any such thing.

I beg your pardon?

>restart
Are you sure you want to restart?

>y
Scaring 101
An Interactive Fiction by Mikrokosmonaut
Release 1 / Serial number 181203 / Inform 7 build 6M62 (I6/v6.33 lib 6/12N) SD

Landing
You can see a wooden door and a ball here.

>haunt ball
Out of nowhere the ball bounces off towards the Hall.

The teddy bear arrives from the inside.

>s
You shimmer through to the Hallway.

Hallway
You can see a bedroom door, a ball, a mirror and a radio here.

The teddy bear arrives from the north.

>haunt radio
The radio switches itself on and begins to cycle through channels seemingly at random.

[Your score has just gone up by three points.]

>z
Time passes.

The teddy bear collapses to the floor in anticipation of someone coming. The bearded man arrives from the inside.

>haunt ball
Out of nowhere the ball bounces off towards the Landing.

---The bearded man looks a little shaken. The bearded man switches the radio off.

The bearded man goes inside.

[Your score has just gone up by one point.]

* * *

>n
You shimmer through to the Landing.

Landing
A framed family photo hangs on the wall. "The illusion of permanence" you think to yourself. A wooden door leads in to the child's bedroom. The hallway itself continues south from here and while there is a staircase leading down to the first floor, all the fun (read horror) is up here.

You can see a ball here.

The teddy bear waddles in from the Child's Bedroom.

>in
You shimmer through to the Child's Bedroom.

Child's Bedroom
A typical kid's bedroom - all bright colours and optimism. You'd spit if you could. A small window paints a trapeziod of light over the young boy. There is a wooden door leading out.

You can see the child's bed (under the covers of which is a sleeping young boy), a lamp and a closet here.

The teddy bear waddles in from the Landing.

>haunt bed
As you haunt the child's bed, it starts to shake back and forth.

The young boy wakes up not quite sure of what's going on. The teddy bear immediately collapses to the floor to avoid being noticed. 

[Your score has just gone up by one point.]

>haunt bed
As you haunt the child's bed, it starts to shake back and forth.

The young boy screams. The young boy gets out of the child's bed.

The young boy runs off to the Landing, looking fairly scared.

[Your score has just gone up by one point.]

>out
You shimmer through to the Landing.

Landing
A framed family photo hangs on the wall. A wooden door leads back in to the child's bedroom. The hallway itself continues south from here and while there is a staircase leading down to the first floor, all the fun is up here.

You can see a young boy and a ball here.

The young boy runs off to the Hallway, looking fairly scared.

>s
You shimmer through to the Hallway.

Hallway
A mirror hangs on the wall here. A bedroom door leads in to the master bedroom. The landing lies to the north.

You can see a young boy and a pedestal (on which is a radio) here.

The young boy runs off to the Master Bedroom, looking fairly scared.

>in
You shimmer through to the Master Bedroom.

Master Bedroom
Moonlight shines in through the large window, the shadow of the frame artificially segmenting the man and woman as if silently commenting on the state of their marriage.  A bedroom door leads back out to the hallway. 

You can see a young boy, the king-sized bed (under the covers of which are a sleeping bearded man and a sleeping young woman), a TV and a bed-side table (on which are an alarm clock and a flashlight) here.

The young boy gets back into the king-sized bed and pulls the covers over himself with a scared look on his face.

* * *

>in
You shimmer through to the Child's Bedroom.

Child's Bedroom
A typical kid's bedroom - all bright colours and optimism. You'd spit if you could. A small window paints a trapeziod of light over the young boy. There is a wooden door leading out.

You can see the child's bed (under the covers of which is a sleeping young boy), a lamp and a closet here.

The teddy bear waddles in from the Landing.

>l
Child's Bedroom
A typical kid's bedroom - all bright colours and optimism. You'd spit if you could. A small window paints a trapeziod of light over the young boy. There is a wooden door leading out.

You can see a teddy bear, the child's bed (under the covers of which is a sleeping young boy), a lamp and a closet here.

* * *

>s
You shimmer through to the Hallway.

Hallway
A mirror hangs on the wall here. "How incredibly vain the living are" you ponder for a few moments. A bedroom door leads in to the master bedroom. The landing lies to the north.

You can see a pedestal (on which is a radio) here.

>n
You shimmer through to the The Landing.

The Landing
You can see a wooden door, a teddy bear, a ball and a family photo here.

>z
Time passes.

I beg your pardon?

* * *

>n
You shimmer through to the The Landing.

The Landing
You can see a wooden door, a teddy bear, a ball and a family photo here.

>out
(first opening the wooden door)

end of the hall
You can see a wooden door here.

You'll have to say which compass direction to go in.
I didn't understand that instruction.

* * *

>n
You shimmer through to the The Landing.

The Landing
You can see a wooden door, a teddy bear, a ball and a family photo here.

>in
You shimmer through to the Child's Bedroom.

Child's Bedroom
You can see a wooden door, the child's bed (under the covers of which is a sleeping young boy), a lamp and a closet (closed) here.

The teddy bear arrives from the outside.

>haunt bed
As you haunt the child's bed, it starts to shake back and forth.

The teddy bear immediately falls to the floor to avoid being noticed.

>haunt bed
As you haunt the child's bed, it starts to shake back and forth.

The young boy screams.

* * *

>s
You shimmer through to the Hallway.

Hallway
A mirror hangs on the wall here. "How incredibly vain the living are" you ponder for a few moments. A bedroom door leads in to the master bedroom. The landing lies to the north.

You can see a pedestal (on which is a radio) here.

>in
You shimmer through to the Master Bedroom.

Master Bedroom
You can see a bedroom door, the king-sized bed (under the covers of which are a sleeping bearded man and a sleeping young woman), a TV and a bed-side table (on which is an alarm clock) here.

>haunt door
The bedroom door starts to rattle.

The bearded man and the young woman wake up wondering what is going on. 

Someone has woken up.

The teddy bear arrives from the outside.

>haunt door
The bedroom door starts to rattle.

The bearded man and the young woman jump with fright.

>look
Master Bedroom
You can see a teddy bear, a bedroom door, the king-sized bed (under the covers of which are a scared bearded man and a scared young woman), a TV, an alarm clock and a large window here.

>haunt bed
As you haunt the king-sized bed, it starts to shake back and forth.

The bearded man and the young woman scream.

>restart
Are you sure you want to restart?

>y
Scaring 101
An Interactive Fiction by Mikrokosmonaut
Release 1 / Serial number 181202 / Inform 7 build 6M62 (I6/v6.33 lib 6/12N) SD

Landing
You can see a wooden door here.

>z
Time passes.

The teddy bear arrives from the inside.

>s
You shimmer through to the Hallway.

Hallway
You can see a bedroom door, a mirror and a radio here.

The teddy bear arrives from the north.

>in
You shimmer through to the Master Bedroom.

Master Bedroom
You can see a bedroom door, the king-sized bed (under the covers of which are a sleeping bearded man and a sleeping young woman), a TV, an alarm clock and a large window here.

The teddy bear arrives from the outside.

>haunt door
The bedroom door starts to rattle.

The bearded man and the young woman jump with fright.

Someone has woken up.

* * *

>in
You shimmer through to the Master Bedroom.

Master Bedroom
You can see a bedroom door, the king-sized bed (under the covers of which are a sleeping bearded man and a sleeping young woman), a TV and a bed-side table (on which is an alarm clock) here.

>haunt tv
The TV switches itself on for a few seconds and then back off again.

The teddy bear arrives from the outside.

>look
Master Bedroom
You can see a teddy bear, a bedroom door, the king-sized bed (under the covers of which are a sleeping bearded man and a sleeping young woman), a TV, an alarm clock and a large window here.

>look
Master Bedroom
You can see a teddy bear, a bedroom door, the king-sized bed (under the covers of which are a sleeping bearded man and a sleeping young woman), a TV, an alarm clock and a large window here.

>haunt alarm
The alarm clock starts ringing suddenly and the sound slowly dies off as if it's just realised that it's out of power.

>look
Master Bedroom
You can see a teddy bear, a bedroom door, the king-sized bed (under the covers of which are a sleeping bearded man and a sleeping young woman), a TV, an alarm clock and a large window here.

* * *

>in
You shimmer through to the Master Bedroom.

Master Bedroom
You can see a bedroom door, the king-sized bed (under the covers of which are a sleeping bearded man and a sleeping young woman), a TV and a bed-side table (on which is an alarm clock) here.

>z
Time passes.

The teddy bear waddles in from the Hallway. The teddy bear whispers "It's worth giving a little thought to rule #3: variety is vital to a good haunt".

>haunt window
The large window starts to rattle.

The bearded man and the young woman wake up wondering what is going on. The teddy bear immediately falls to the floor to avoid being noticed. 

[Your score has just gone up by two points.]

>out
You shimmer through to the Hallway.

Hallway
You can see a bedroom door, a mirror and a pedestal (on which is a radio) here.

The teddy bear quietly crawls out from the Master Bedroom. The teddy bear gets to his feet.

>in
You shimmer through to the Master Bedroom.

Master Bedroom
You can see a bedroom door, the king-sized bed (under the covers of which are a confused bearded man and a confused young woman), a TV and a bed-side table (on which is an alarm clock) here.

>out
You shimmer through to the Hallway.

Hallway
You can see a bedroom door, a teddy bear, a mirror and a pedestal (on which is a radio) here.

>haunt radio
The radio switches itself on and begins to cycle through channels seemingly at random.

[Your score has just gone up by one point.]

>z
Time passes.

The teddy bear collapses to the floor in anticipation of someone coming. The bearded man arrives from the Master Bedroom, looking quite confused.

>z
Time passes.

With a confused look on his face, the bearded man switches the radio off.

The bearded man goes to the Master Bedroom, looking fairly confused.

>z
Time passes.

The teddy bear gets to his feet.

>z
Time passes.

>z
Time passes.

The teddy bear whispers "It's worth giving a little thought to rule #1: always consider your surroundings".

* * *

>s
You shimmer through to the Hallway.

Hallway
A mirror hangs on the wall here. "How incredibly vain the living are" you ponder for a few moments. A bedroom door leads in to the master bedroom. The landing lies to the north.

You can see a pedestal (on which is a radio) here.

>z
Time passes.

The teddy bear waddles in from the Landing.

>haunt radio
The radio switches itself on and begins to cycle through channels seemingly at random.

[Your score has just gone up by three points.]

>z
Time passes.

The teddy bear immediately falls to the floor to avoid being noticed. The bearded man arrives from the inside.

>z
Time passes.

The young boy arrives from the north.

>z
Time passes.

The teddy bear immediately falls to the floor to avoid being noticed. The young boy switches the radio off.

The young boy goes north.

>n
You shimmer through to the Landing.

Landing
You can see a wooden door and a young boy here.

The young boy goes inside.

>in
You shimmer through to the Child's Bedroom.

Child's Bedroom
You can see a wooden door, a young boy, the child's bed, a lamp and a closet (empty) here.

The young boy gets into the child's bed.

>x boy
You see nothing special about the young boy.

>look
Child's Bedroom
You can see a wooden door, the child's bed (under the covers of which is a confused young boy), a lamp and a closet (empty) here.

>restart
Are you sure you want to restart?

>y
Scaring 101
An Interactive Fiction by Mikrokosmonaut
Release 1 / Serial number 181203 / Inform 7 build 6M62 (I6/v6.33 lib 6/12N) SD

Landing
You can see a wooden door here.

>s
You shimmer through to the Hallway.

Hallway
You can see a bedroom door, a mirror and a radio here.

>haunt radio
The radio switches itself on and begins to cycle through channels seemingly at random.

The teddy bear arrives from the north.

[Your score has just gone up by three points.]

>z
Time passes.

The bearded man arrives from the inside.

>in
You shimmer through to the Master Bedroom.

Master Bedroom
You can see a bedroom door, the king-sized bed (under the covers of which is a confused young woman), a TV and an alarm clock here.

The bearded man arrives from the outside.

>z
Time passes.

The bearded man gets into the king-sized bed.

>z
Time passes.

>look
Master Bedroom
You can see a bedroom door, the king-sized bed (under the covers of which are a confused bearded man and a confused young woman), a TV and an alarm clock here.

>restart
Are you sure you want to restart?

* * *

>y
Scaring 101
An Interactive Fiction by Mikrokosmonaut
Release 1 / Serial number 181203 / Inform 7 build 6M62 (I6/v6.33 lib 6/12N) SD

Landing
You can see a wooden door here.

>n
You can't go that way.

The teddy bear arrives from the inside.

>s
You shimmer through to the Hallway.

Hallway
You can see a bedroom door, a mirror and a radio here.

The teddy bear arrives from the north.

>haunt radio
The radio switches itself on and begins to cycle through channels seemingly at random.

[Your score has just gone up by three points.]

>s
You can't go that way.

The young woman arrives from the inside.

>haunt radio
The radio switches itself on and begins to cycle through channels seemingly at random.

The young woman jumps with fright. The teddy bear immediately falls to the floor to avoid being noticed. The young woman switches the radio off.

The young woman goes inside.

[Your score has just gone up by one point.]

>in
You shimmer through to the Master Bedroom.

Master Bedroom
You can see a bedroom door, a young woman, the king-sized bed (under the covers of which is a confused bearded man), a TV and an alarm clock here.

The young woman gets into the king-sized bed.

>look
Master Bedroom
You can see a bedroom door, the king-sized bed (under the covers of which are a scared young woman and a confused bearded man), a TV and an alarm clock here.

>haunt tv
The TV switches itself on and begins to cycle through channels seemingly at random.

The bearded man and the young woman scream. The young woman switches the TV off.

[Your score has just gone up by one point.]

* * *

>z
Time passes.

The teddy bear waddles in from the Landing.

>z
Time passes.

>haunt radio
The radio switches itself on and begins to cycle through channels seemingly at random.

[Your score has just gone up by three points.]

>z
Time passes.

The teddy bear gets to his feet.

>z
Time passes.

The teddy bear collapses to the floor in anticipation of someone coming. The young boy arrives from the north.

>z
Time passes.

The young boy switches the radio off.

The young boy goes north.

>z
Time passes.

The teddy bear gets to his feet.

* * *

>s
You shimmer through to the Hallway.

Hallway
A mirror hangs on the wall here. "How incredibly vain the living are" you ponder for a few moments. A bedroom door leads in to the master bedroom. The landing lies to the north.

You can see a pedestal (on which is a radio) here.

>haunt radio
The radio switches itself on and begins to cycle through channels seemingly at random.

The teddy bear waddles in from the Landing.

[Your score has just gone up by three points.]

>z
Time passes.

The young woman arrives from the Master Bedroom, looking quite confused.

>z
Time passes.

The teddy bear immediately falls to the floor to avoid being noticed. With a confused look on her face, the young woman switches the radio off.

The young woman goes to the Master Bedroom, looking fairly confused.

* * *

>s
You shimmer through to the Hallway.

Hallway
A mirror hangs on the wall here. "How incredibly vain the living are" you ponder for a few moments. A bedroom door leads in to the master bedroom. The landing lies to the north.

You can see a pedestal (on which is a radio) here.

>haunt pedestal
The pedestal starts to shake aggressively causing the radio to rattle.

The teddy bear arrives from the north.

>haunt pedestal
The pedestal starts to shake aggressively causing the radio to rattle.

>haunt pedestal
The pedestal starts to shake aggressively causing the radio to rattle.

The radio falls to the floor.

>haunt pedestal
The pedestal starts to shake aggressively.

>look
Hallway
You can see a radio, a teddy bear, a bedroom door, a mirror and a pedestal here.

>haunt radio
The radio switches itself on and begins to cycle through channels seemingly at random.

[Your score has just gone up by three points.]

* * *

>s
You shimmer through to the Hallway.

Hallway
A mirror hangs on the wall here. "How incredibly vain the living are" you ponder for a few moments. A bedroom door leads in to the master bedroom. The landing lies to the north.

You can see a pedestal (on which is a radio) here.

>haunt mirror
(Easter Egg) The mirror displays the Windows ME logo. Just the thought is enough to make even a poltergeist shiver.

The teddy bear waddles in from the Landing. 

[Your score has just gone up by two points.]

>in
You shimmer through to the The Master Bedroom.

The Master Bedroom
You can see a bedroom door, the king-sized bed (under the covers of which are a sleeping bearded man and a sleeping young woman), a TV and a bed-side table (on which is an alarm clock) here.

The teddy bear waddles in from the The Hallway.

>out
You shimmer through to the The Hallway.

The Hallway
You can see a bedroom door, a mirror and a pedestal (on which is a radio) here.

The teddy bear waddles in from the The Master Bedroom.

* * *

>out
You shimmer through to the Hallway.

Hallway
A mirror hangs on the wall here. "How incredibly vain the living are" you ponder for a few moments. A bedroom door leads back in to the master bedroom. The landing lies to the north.

You can see a pedestal (on which is a radio) here.

>go out
You shimmer through to the Hallway.

Hallway
You can see a bedroom door, a mirror and a pedestal (on which is a radio) here.

The teddy bear arrives from the north.

>go out
You can't go that way.

You'll have to say which compass direction to go in.
I didn't understand that instruction.

>z
Time passes.

You'll have to say which compass direction to go in.
I didn't understand that instruction.

>z
Time passes.

You'll have to say which compass direction to go in.
I didn't understand that instruction.

>look
end of the hall
You can see a wooden door here.

You'll have to say which compass direction to go in.
I didn't understand that instruction.

>n
You can't go that way.

You'll have to say which compass direction to go in.
I didn't understand that instruction.

>s
You can't go that way.

You'll have to say which compass direction to go in.
I didn't understand that instruction.

>in
Child's Bedroom
You can see a wooden door, the child's bed (in which is a sleeping young boy) and a teddy bear here.

>z
Time passes.

>x door
You see nothing special about the wooden door.

* * *

>go out
You shimmer through to the Hallway.

Hallway
You can see a bedroom door, a mirror and a pedestal (on which is a radio) here.

The teddy bear arrives from the north.

>s
You can't go that way.

>n
You shimmer through to the Landing.

Landing
You can see a wooden door and a ball here.

The teddy bear arrives from the south.

>in
You shimmer through to the Child's Bedroom.

Child's Bedroom
You can see a wooden door, the child's bed (under the covers of which is a sleeping young boy), a lamp and a closet (closed) here.

The teddy bear arrives from the outside.

>haunt bed
As you haunt the child's bed, it starts to shake back and forth.

>haunt bed
As you haunt the child's bed, it starts to shake back and forth.

* * *

>out
You shimmer through to the Hallway.

Hallway
A mirror hangs on the wall here. "How incredibly vain the living are" you ponder for a few moments. A bedroom door leads back in to the master bedroom. The landing lies to the north.

You can see a pedestal (on which is a radio) here.

>in
You shimmer through to the Master Bedroom.

Master Bedroom
You can see a bedroom door, the king-sized bed (under the covers of which are a sleeping bearded man and a sleeping young woman), a TV, an alarm clock and a large window here.

>z
Time passes.

The teddy bear arrives from the outside.

>haunt door
The bedroom door rattles aggressively.

The bearded man and the young woman wake up with a start. 

[Your score has just gone up by three points.]

>look
Master Bedroom
You can see a teddy bear, a bedroom door, the king-sized bed (under the covers of which are an unsettled bearded man and an unsettled young woman), a TV, an alarm clock and a large window here.

* * *

>out
You shimmer through to the Hallway.

Hallway
A mirror hangs on the wall here. "How incredibly vain the living are" you ponder for a few moments. A bedroom door leads back in to the master bedroom. The landing lies to the north.

You can see a pedestal (on which is a radio) here.

>x door
The wooden door is open.

>restart
Are you sure you want to restart?

>y
Scaring 101
An Interactive Fiction by Mikrokosmonaut
Release 1 / Serial number 181202 / Inform 7 build 6M62 (I6/v6.33 lib 6/12N) SD

Child's Bedroom
You can see a wooden door, the child's bed (in which is a sleeping young boy) and a teddy bear here.

>x door
The wooden door is closed.

>out
end of the hall
You can see a wooden door here.

The teddy bear arrives from the inside.

>look
end of the hall
You can see a teddy bear and a wooden door here.

>x door
The wooden door is open.

* * *

>out
You shimmer through to the Hallway.

Hallway
A mirror hangs on the wall here. "How incredibly vain the living are" you ponder for a few moments. A bedroom door leads back in to the master bedroom. The landing lies to the north.

You can see a pedestal (on which is a radio) here.

>haunt door
The wooden door slams shut.

[Your score has just gone up by three points.]

>in
You shimmer through to the Child's Bedroom.

Child's Bedroom
You can see a wooden door, the child's bed (under the covers of which is a confused young boy), a lamp and a closet (empty) here.

* * *

>look
Child's Bedroom
You can see a teddy bear, a wooden door, the child's bed (in which is a scared young boy) and a lamp here.

>restart
Are you sure you want to restart?

>y
Scaring 101
An Interactive Fiction by Mikrokosmonaut
Release 1 / Serial number 181202 / Inform 7 build 6M62 (I6/v6.33 lib 6/12N) SD

Child's Bedroom
You can see a wooden door, the child's bed (in which is a sleeping young boy), a teddy bear and a lamp here.

>out
end of the hall
You can see a wooden door here.

The teddy bear arrives from the inside.

* * *

>in
You shimmer through to the Child's Bedroom.

Child's Bedroom
You can see a wooden door, the child's bed (under the covers of which is a confused young boy), a lamp and a closet (empty) here.

>restart
Are you sure you want to restart?

* * *

>y
Scaring 101
An Interactive Fiction by Mikrokosmonaut
Release 1 / Serial number 181202 / Inform 7 build 6M62 (I6/v6.33 lib 6/12N) SD

Child's Bedroom
You can see a wooden door, the child's bed (in which is a sleeping young boy), a teddy bear and a lamp here.

>haunt door
The young boy wakes up wondering what is going on.

Someone has woken up.

>look
Child's Bedroom
You can see a wooden door, the child's bed (in which is a suspicious young boy), a teddy bear and a lamp here.

>haunt door
The young boy is confused.

>look
Child's Bedroom
You can see a wooden door, the child's bed (in which is a suspicious young boy), a teddy bear and a lamp here.

>out
end of the hall
You can see a wooden door here.

The teddy bear arrives from the inside.

* * *

>in
Child's Bedroom
You can see a wooden door, the child's bed (in which is a suspicious young boy) and a lamp here.

The teddy bear arrives from the outside.

* * *

>y
Scaring 101
An Interactive Fiction by Mikrokosmonaut
Release 1 / Serial number 181202 / Inform 7 build 6M62 (I6/v6.33 lib 6/12N) SD

Child's Bedroom
You can see a wooden door, the child's bed (in which is a sleeping young boy), a teddy bear and a lamp here.

>open door
You open the wooden door.

>look
Child's Bedroom
You can see a wooden door, the child's bed (in which is a sleeping young boy), a teddy bear and a lamp here.

>x door
The wooden door is open.

>haunt door
Someone has woken up.

>look
Child's Bedroom
You can see a wooden door, the child's bed (in which is a scared young boy), a teddy bear and a lamp here.

>restart
Are you sure you want to restart?

* * *

>out
end of the hall
You can see a wooden door here.

The teddy bear arrives from the inside.

>x door
The wooden door is open.

* * *

>haunt door
Someone has woken up.

>in
Child's Bedroom
You can see a wooden door, the child's bed (in which is a suspicious young boy) and a lamp here.

The teddy bear arrives from the outside.

* * *

>in
You shimmer through to the Child's Bedroom.

Child's Bedroom
You can see a wooden door, the child's bed (under the covers of which is a confused young boy), a lamp and a closet (empty) here.

>haunt lamp
The bulb of the lamp flickers on and off for a few seconds.

The young boy looks a little shaken. The young boy switches the lamp off.

[Your score has just gone up by one point.]

>haunt window
The small window starts to rattle.

The young boy looks unsettled enough as it is.

>haunt bed
As you haunt the child's bed, it starts to shake back and forth.

The young boy screams. 

[Your score has just gone up by one point.]

>out
You shimmer through to the Landing.

Landing
You can see a wooden door, a teddy bear and a ball here.

>s
You shimmer through to the Hallway.

Hallway
You can see a bedroom door, a mirror and a radio here.

The teddy bear arrives from the north.

>haunt radio
The radio switches itself on and begins to cycle through channels seemingly at random.

>look
Hallway
You can see a teddy bear, a bedroom door, a mirror and a radio here.

The teddy bear collapses to the floor in anticipation of someone coming. The young woman arrives from the inside.

>haunt mirror
The mirror perverts the reflection of the young woman into a hideous caricature.

The young woman screams. The young woman switches the radio off.

The young woman goes inside.

[Your score has just gone up by one point.]

>in
You shimmer through to the Master Bedroom.

Master Bedroom
You can see a bedroom door, a young woman, the king-sized bed (under the covers of which is a confused bearded man), a TV and an alarm clock here.

The young woman gets into the king-sized bed.

>z
Time passes.

>l
Master Bedroom
You can see a bedroom door, the king-sized bed (under the covers of which are a scared young woman and a confused bearded man), a TV and an alarm clock here.

>haunt alarm
The alarm clock suddenly starts ringing.

The bearded man and the young woman jump with fright. 

    *** The teddy bear high fives you! ***

In that game you scored 7 out of a possible 9, in 15 turns.

Would you like to RESTART, RESTORE a saved game, QUIT or UNDO the last command?

* * *

>out
You shimmer through to the Hallway.

Hallway
A mirror hangs on the wall here. "How incredibly vain the living are" you ponder for a few moments. A bedroom door leads back in to the master bedroom. The landing lies to the north.

You can see a pedestal (on which is a radio) here.

>s
You can't go that way.

The teddy bear waddles in from the Landing.

>in
You shimmer through to the Master Bedroom.

Master Bedroom
Moonlight shines in through the large window, the shadow of the frame artificially segmenting the man and woman as if silently commenting on the state of their marriage.  A bedroom door leads back out to the hallway. 

You can see the king-sized bed (under the covers of which are a sleeping bearded man and a sleeping young woman), a TV and a bed-side table (on which are an alarm clock and a flashlight) here.

The teddy bear waddles in from the Hallway. The teddy bear whispers "It's worth giving a little thought to rule #3: variety is vital to a good haunt".

>haunt bed
As you haunt the king-sized bed, it starts to shake back and forth.

The bearded man jumps with a fright.
The young woman jumps with a fright.

Someone has woken up.

>look
Master Bedroom
You can see a teddy bear, a bedroom door, the king-sized bed (in which are a bearded man and a young woman sleeping), a TV, an alarm clock and a large window here.

>look
Master Bedroom
You can see a teddy bear, a bedroom door, the king-sized bed (in which are a bearded man and a young woman sleeping), a TV, an alarm clock and a large window here.

* * *

>haunt tv
The TV switches itself on and begins to cycle through channels seemingly at random.

>haunt alarm
The bearded man and the young woman wake up with a start. 

The alarm clock suddenly starts ringing.

The bearded man switches the TV off.

The bearded man switches the alarm clock off.

>look
Master Bedroom
You can see a teddy bear, a bedroom door, the king-sized bed (under the covers of which are an unsettled bearded man and an unsettled young woman), a TV, an alarm clock and a large window here.

>haunt alarm
The alarm clock starts ringing suddenly and the sound slowly dies off as if it's just realised that it's out of power.

The bearded man and the young woman jump with fright.

>look
Master Bedroom
You can see a teddy bear, a bedroom door, the king-sized bed (under the covers of which are a scared bearded man and a scared young woman), a TV, an alarm clock and a large window here.

>out
You shimmer through to the Hallway.

Hallway
You can see a bedroom door, a mirror and a radio here.

The teddy bear arrives from the inside.

>n
You shimmer through to the Landing.

Landing
You can see a wooden door here.

The teddy bear arrives from the south.

>in
You shimmer through to the Child's Bedroom.

Child's Bedroom
You can see a wooden door, the child's bed (under the covers of which is a confused young boy), a lamp and a closet (empty) here.

The teddy bear arrives from the outside.

>haunt door
The wooden door starts to rattle.

The young boy jumps with fright.

>look
Child's Bedroom
You can see a teddy bear, a wooden door, the child's bed (under the covers of which is a scared young boy), a lamp and a closet (empty) here.

* * *

>look
Master Bedroom
You can see a teddy bear, a bedroom door, the king-sized bed (under the covers of which are an unsettled bearded man and an unsettled young woman), a TV, an alarm clock and a large window here.

>haunt tv
The bearded man and the young woman scream.

The TV switches itself on and begins to cycle through channels seemingly at random.

The young woman switches the TV off.

* * *

>haunt alarm
The bearded man and the young woman wake up with a start. 

The young woman switches the alarm clock off.

>haunt door
The bearded man and the young woman jump with fright.

>haunt alarm
The bearded man and the young woman jump with fright.

The young woman switches the alarm clock off.

>haunt alarm
The bearded man and the young woman jump with fright.

The bearded man switches the alarm clock off.

>haunt alarm
The bearded man and the young woman jump with fright.

The young woman switches the alarm clock off.

* * *

>l
Master Bedroom
Moonlight shines in through the large window, the shadow of the frame artificially segmenting the man and woman as if silently commenting on the state of their marriage.  A bedroom door leads back out to the hallway. 

You can see a teddy bear, the king-sized bed (under the covers of which are a sleeping bearded man and a sleeping young woman), a TV and a bed-side table (on which are an alarm clock and a flashlight) here.

* * *

>s
You can't go that way.

The teddy bear waddles in from the Landing.

>haunt radio
The radio switches itself on and begins to cycle through channels seemingly at random.

[Your score has just gone up by three points.]

>z
Time passes.

The young woman arrives from the Hallway, looking quite confused.

The teddy bear whispers "Keep in mind rule #1: always consider your surroundings".

>z
Time passes.

The teddy bear immediately falls to the floor to avoid being noticed. With a confused look on her face, the young woman switches the radio off.

The young woman goes to the Master Bedroom, looking fairly confused.

>z
Time passes.

The teddy bear gets to his feet.

>z
Time passes.

The teddy bear gets to his feet.

* * *

>z
Time passes.

>look
Hallway
You can see a teddy bear, a bedroom door, a mirror and a radio here.

>in
You shimmer through to the Master Bedroom.

Master Bedroom
You can see a bedroom door, the king-sized bed (under the covers of which are a confused bearded man and a confused young woman), a TV and an alarm clock here.

>things
That's not a verb I recognise.

>showme things
mirror - thing
location: in the Hallway
singular-named, improper-named; unlit, inedible, portable, unhauntable
list grouping key: none
printed name: "mirror"
printed plural name: none
indefinite article: none
description: none
initial appearance: none
weirdness: none

>showme people
There seems to be no such object anywhere in the model world.

>showme man
bearded man - victim
location: in the king-sized bed in the Master Bedroom
singular-named, improper-named; unlit, inedible, portable, unhauntable; male, passive
list grouping key: none
printed name: "bearded man"
printed plural name: "victims"
indefinite article: none
description: none
initial appearance: none
weirdness: none
carrying capacity: 100
quarters: Master Bedroom
fear-state: confused

>showme woman
young woman - victim
location: in the king-sized bed in the Master Bedroom
singular-named, improper-named; unlit, inedible, portable, unhauntable; male, passive
list grouping key: none
printed name: "young woman"
printed plural name: "victims"
indefinite article: none
description: none
initial appearance: none
weirdness: none
carrying capacity: 100
quarters: Master Bedroom
fear-state: confused

* * *

>z
Time passes.

The teddy bear gets to his feet.

>haunt radio
The radio switches itself on and begins to cycle through channels seemingly at random.

>z
Time passes.

The teddy bear collapses to the floor in anticipation of someone coming. The young woman arrives from the inside.

>z
Time passes.

The young woman switches the radio off.

The young woman goes inside.

>z
Time passes.

The teddy bear gets to his feet.

>haunt radio
The radio switches itself on and begins to cycle through channels seemingly at random.

The teddy bear whispers "Don't forget rule #2: make sure to take your time".

>z
Time passes.

The teddy bear whispers "It's worth giving a little thought to rule #3: variety is vital to a good haunt".

>z
Time passes.

The young boy arrives from the Hallway, looking quite confused.

The teddy bear whispers "Keep in mind rule #2: make sure to take your time".

>n
You shimmer through to the Landing.

Landing
You can see a wooden door and a ball here.

The teddy bear waddles in from the Landing.

The teddy bear gets to his feet. The young boy arrives from the Landing, looking quite confused.

>in
You shimmer through to the Child's Bedroom.

Child's Bedroom
You can see a wooden door, the child's bed, a lamp and a closet here.

The teddy bear waddles in from the Child's Bedroom.

The teddy bear gets to his feet. The young boy arrives from the Child's Bedroom, looking quite confused.

The teddy bear whispers "Keep in mind rule #3: variety is vital to a good haunt".

>z
Time passes.

The teddy bear immediately falls to the floor to avoid being noticed. The young boy gets back into the child's bed and pulls the covers over himself with a confused look on his face.

>look
Child's Bedroom
You can see a teddy bear, a wooden door, the child's bed (under the covers of which is a confused young boy), a lamp and a closet here.

>out
You shimmer through to the Landing.

Landing
You can see a wooden door and a ball here.

The teddy bear waddles in from the Landing.

The teddy bear gets to his feet. 

The teddy bear whispers "Keep in mind rule #1: always consider your surroundings".

* * *

>z
Time passes.

The young woman arrives from the Hallway, looking quite confused.

The teddy bear whispers "Keep in mind rule #1: always consider your surroundings".

>restart
Are you sure you want to restart?

>y
Scaring 101
An Interactive Fiction by Mikrokosmonaut
Release 1 / Serial number 181203 / Inform 7 build 6M62 (I6/v6.33 lib 6/12N) SD

Hallway
You can see a bedroom door, a mirror and a radio here.

>haunt radio
The radio switches itself on and begins to cycle through channels seemingly at random.

[Your score has just gone up by three points.]

>z
Time passes.

The teddy bear arrives from the north.

The teddy bear collapses to the floor in anticipation of someone coming. The young woman arrives from the inside.

>z
Time passes.

The young woman switches the radio off.

The young woman goes inside.

>z
Time passes.

* * *

>z
Time passes.

The young woman arrives from the Hallway, looking quite confused.

The teddy bear whispers "Keep in mind rule #1: always consider your surroundings".

>haunt mirror
The mirror perverts the reflection of the bearded man into a hideous caricature.

The bearded man screams. The teddy bear immediately falls to the floor to avoid being noticed. With a scared on his face, the bearded man switches the radio off

The bearded man goes to the Master Bedroom, looking scared.

[Your score has just gone up by one point.]

* * *

>z
Time passes.

The young woman arrives from the Hallway, looking quite confused.

The teddy bear whispers "Keep in mind rule #1: always consider your surroundings".

>in
You shimmer through to the Master Bedroom.

Master Bedroom
You can see a bedroom door, the king-sized bed (under the covers of which is a confused young woman), a TV and a bed-side table (on which is an alarm clock) here.

The bearded man arrives from the Master Bedroom, looking quite confused.

>look
Master Bedroom
You can see a bearded man, a bedroom door, the king-sized bed (under the covers of which is a confused young woman), a TV and a bed-side table (on which is an alarm clock) here.

The bearded man gets back into the king-sized bed and pulls the covers over himself with a confused look on his face.

>restart
Are you sure you want to restart?

>y
Scaring 101
An Interactive Fiction by Mikrokosmonaut
Release 1 / Serial number 181204 / Inform 7 build 6M62 (I6/v6.33 lib 6/12N) SD

Hallway
You can see a bedroom door, a mirror and a pedestal (on which is a radio) here.

>haunt radio
The radio switches itself on and begins to cycle through channels seemingly at random.

[Your score has just gone up by three points.]

>z
Time passes.

The teddy bear waddles in from the Hallway.

>z
Time passes.

The young boy arrives from the Hallway, looking quite confused.

>n
You shimmer through to the Landing.

Landing
You can see a wooden door and a ball here.

The teddy bear waddles in from the Landing.

The teddy bear gets to his feet. The young boy arrives from the Landing, looking quite confused.

>in
You shimmer through to the Child's Bedroom.

Child's Bedroom
You can see a wooden door, the child's bed, a lamp and a closet here.

The teddy bear waddles in from the Child's Bedroom.

The teddy bear gets to his feet. The young boy arrives from the Child's Bedroom, looking quite confused.

>z
Time passes.

The teddy bear immediately falls to the floor to avoid being noticed. The young boy gets back into the child's bed and pulls the covers over himself with a confused look on his face.

* * *

>haunt radio
The radio switches itself on and begins to cycle through channels seemingly at random.

[Your score has just gone up by three points.]

>in
You shimmer through to the Master Bedroom.

Master Bedroom
You can see a bedroom door, a bearded man, the king-sized bed (under the covers of which is a confused young woman), a TV and a bed-side table (on which is an alarm clock) here.

The teddy bear collapses to the floor in anticipation of someone coming. The bearded man goes to the Hallway, looking fairly confused.

>z
Time passes.

The teddy bear immediately falls to the floor to avoid being noticed. Someone can see the radio.

The young woman arrives from the outside.

>z
Time passes.

>look
Master Bedroom
You can see a young woman, a bedroom door, the king-sized bed (under the covers of which is a confused bearded man), a TV and an alarm clock here.

* * *

>in
You shimmer through to the Master Bedroom.

Master Bedroom
You can see a bedroom door, a bearded man, the king-sized bed (under the covers of which is a confused young woman), a TV and a bed-side table (on which is an alarm clock) here.

The teddy bear collapses to the floor in anticipation of someone coming. The bearded man goes to the Hallway, looking fairly confused.

>look
Master Bedroom
You can see a bedroom door, the king-sized bed (under the covers of which is a confused young woman), a TV and a bed-side table (on which is an alarm clock) here.

The bearded man arrives from the Master Bedroom, looking quite confused.

>restart
Are you sure you want to restart?

>y
Scaring 101
An Interactive Fiction by Mikrokosmonaut
Release 1 / Serial number 181204 / Inform 7 build 6M62 (I6/v6.33 lib 6/12N) SD

Landing
You can see a wooden door and a ball here.

>s
You shimmer through to the Hallway.

Hallway
You can see a bedroom door, a mirror and a pedestal (on which is a radio) here.

>haunt radio
The radio switches itself on and begins to cycle through channels seemingly at random.

The teddy bear waddles in from the Hallway.

[Your score has just gone up by three points.]

>z
Time passes.

>z
Time passes.

The young boy arrives from the Hallway, looking quite confused.

* * *

>s
You can't go that way.

The teddy bear waddles in from the Landing.

>haunt mirror
(Easter Egg) The mirror displays the Windows ME logo. Just the thought is enough to make even a poltergeist shiver.

[Your score has just gone up by one point.]

>haunt mirror
The mirror displays a rolling landscape of faces, each wrought in its own particular kind of suffering.

>haunt mirror
The mirror displays a rolling landscape of faces, each stretched out in its own kind of suffering.

>haunt mirror
The mirror displays a rolling landscape of faces, each stretched out in its own kind of suffering.

* * *

>haunt mirror
The mirror displays a rolling landscape of faces, each wrought in its own particular kind of suffering.

>restart
Are you sure you want to restart?

>y
Scaring 101
An Interactive Fiction by Mikrokosmonaut
Release 1 / Serial number 181205 / Inform 7 build 6M62 (I6/v6.33 lib 6/12N) SD

Master Bedroom
Moonlight shines in through the large window, the shadow of the frame artificially segmenting the man and woman as if silently commenting on the state of their marriage.  A bedroom door leads out to the hallway. 

You can see the king-sized bed (under the covers of which are a sleeping bearded man and a sleeping young woman), a TV and a bed-side table (on which are an alarm clock and a flashlight) here.

>out
You shimmer through to the Hallway.

Hallway
A mirror hangs on the wall here. "How incredibly vain the living are" you ponder for a few moments. A bedroom door leads back in to the master bedroom. The landing lies to the north.

You can see a pedestal (on which is a radio) here.

>haunt radio
The radio switches itself on and begins to cycle through channels seemingly at random.

The teddy bear waddles in from the Landing. 

[Your score has just gone up by three points.]

>z
Time passes.

>z
Time passes.

The teddy bear collapses to the floor in anticipation of someone coming. The young boy arrives from the Landing, looking quite confused.

>haunt mirror
The mirror perverts the reflection of the young boy into a hideous caricature.

The young boy screams. With a scared look on his face, the young boy switches the radio off.

The young boy goes to the Landing, looking fairly scared.

[Your score has just gone up by one point.]

>haunt mirror
(Easter Egg) The mirror displays the Windows ME logo. Just the thought is enough to make even a poltergeist shiver.

The teddy bear gets to his feet. The teddy bear whispers "It's worth giving a little thought to rule #2: make sure to take your time".

[Your score has just gone up by one point.]

>out
You can't go that way.

>look
Hallway
A mirror hangs on the wall here. A bedroom door leads back in to the master bedroom. The landing lies to the north.

You can see a teddy bear and a pedestal (on which is a radio) here.

The teddy bear whispers "It's worth giving a little thought to rule #1: always consider your surroundings".

>in
You shimmer through to the Master Bedroom.

Master Bedroom
Moonlight shines in through the large window, the shadow of the frame artificially segmenting the man and woman as if silently commenting on the state of their marriage.  A bedroom door leads back out to the hallway. 

You can see the king-sized bed (under the covers of which are a confused bearded man and a confused young woman), a TV and a bed-side table (on which are an alarm clock and a flashlight) here.

>haunt flashlight
The flashlight flickers on and off randomly for a few seconds.

The bearded man and the young woman look a little shaken. With an unsettled look on his face, the bearded man switches the flashlight off.

[Your score has just gone up by two points.]

>x man
The bearded man looks pretty unsettled.

* * *

>s
You can't go that way.

The teddy bear waddles in from the Landing.

>n
You shimmer through to the Landing.

Landing
A framed family photo hangs on the wall. "The illusion of permanence" you think to yourself. A wooden door leads in to the child's bedroom. The hallway itself continues south from here and while there is a staircase leading down to the first floor, all the fun (read horror) is up here.

You can see a ball here.

The teddy bear waddles in from the Hallway.

>haunt photo
One by one, the individual eyes of each family member are poked out as if by an invisible pencil. As they lose their eyes, the expression on their face takes on a particularly uncanny smile.

The very moment this grotesque work of performance art comes to a finish, the photo returns to normal.

* * *

>n
You shimmer through to the Landing.

Landing
A framed family photo hangs on the wall. "The illusion of permanence" you think to yourself. A wooden door leads in to the child's bedroom. The hallway itself continues south from here and while there is a staircase leading down to the first floor, all the fun (read horror) is up here.

You can see a ball here.

The teddy bear waddles in from the Hallway.

>in
You shimmer through to the Child's Bedroom.

Child's Bedroom
A typical kid's bedroom - all bright colours and optimism. You'd spit if you could. A small window paints a trapeziod of light over the young boy. There is a wooden door leading out.

You can see the child's bed (under the covers of which is a sleeping young boy), a lamp and a closet here.

The teddy bear waddles in from the Landing. The teddy bear whispers "It's worth giving a little thought to rule #1: always consider your surroundings".

>haunt bed
As you haunt the child's bed, it starts to shake back and forth.

The young boy wakes up not quite sure of what's going on. The teddy bear immediately collapses to the floor to evade suspicion. 

[Your score has just gone up by one point.]

>haunt bed
As you haunt the child's bed, it starts to shake back and forth.

The young boy screams. The young boy leaps out

The young boy runs off to the Landing, looking fairly scared.

[Your score has just gone up by one point.]

* * *

>s
You can't go that way.

The teddy bear waddles in from the Landing.

>l
Hallway
A mirror hangs on the wall here. A bedroom door leads in to the master bedroom. The landing lies to the north.

You can see a teddy bear and a pedestal (on which is a radio) here.

The teddy bear whispers "Keep in mind rule #3: variety is vital to a good haunt".

>in
You shimmer through to the Master Bedroom.

Master Bedroom
Moonlight shines in through the large window, the shadow of the frame artificially segmenting the man and woman as if silently commenting on the state of their marriage.

You can see a bedroom door, the king-sized bed (under the covers of which are a sleeping bearded man and a sleeping young woman), a TV and a bed-side table (on which are an alarm clock and a torch) here.

The teddy bear waddles in from the Hallway.

>l
Master Bedroom
Moonlight shines in through the large window, the shadow of the frame artificially segmenting the man and woman as if silently commenting on the state of their marriage.

You can see a teddy bear, a bedroom door, the king-sized bed (under the covers of which are a sleeping bearded man and a sleeping young woman), a TV and a bed-side table (on which are an alarm clock and a torch) here.

* * *

>out
You shimmer through to the Hallway.

Hallway
A mirror hangs on the wall here. "How incredibly vain the living are" you ponder for a few moments. A bedroom door leads back in to the master bedroom. The landing lies to the north.

You can see a pedestal (on which is a radio) here.

>down
There's probably nobody down there to scare.

* * *

>out
You shimmer through to the Hallway.

Hallway
A mirror hangs on the wall here. "How incredibly vain the living are" you ponder for a few moments. A bedroom door leads back in to the master bedroom. The landing lies to the north.

You can see a pedestal (on which is a radio) here.

>n
You shimmer through to the Landing.

Landing
A framed family photo hangs on the wall. "The illusion of permanence" you think to yourself. A wooden door leads in to the child's bedroom. The hallway itself continues south from here and while there is a staircase leading down to the first floor, all the fun (read horror) is up here.

You can see a teddy bear and a ball here.

>down
There's probably nobody down there to scare.

>s
You shimmer through to the Hallway.

Hallway
You can see a bedroom door, a mirror and a radio here.

The teddy bear arrives from the north.

>in
You shimmer through to the Master Bedroom.

Master Bedroom
You can see a bedroom door, the king-sized bed (in which is a sleeping middle-aged man), a TV, an alarm clock and a large window here.

The teddy bear arrives from the outside.

>haunt bed
As you haunt the king-sized bed, it starts to shake back and forth.

The middle-aged man jumps with a fright.
Middle-aged woman jumps with a fright.

Someone has woken up.

* * *

>n
You shimmer through to the Landing.

Landing
A framed family photo hangs on the wall. "The illusion of permanence" you think to yourself. A wooden door leads in to the child's bedroom. The hallway itself continues south from here and while there is a staircase leading down to the first floor, all the fun (read horror) is up here.

You can see a teddy bear and a ball here.

>in
You shimmer through to the Child's Bedroom.

Child's Bedroom
A typical kid's bedroom - all bright colours and optimism. You'd spit if you could. A small window paints a trapeziod of light over the young boy. There is a wooden door leading out.

You can see the child's bed (under the covers of which is a sleeping young boy), a lamp and a closet here.

The teddy bear waddles in from the Landing. The teddy bear whispers "It's worth giving a little thought to rule #2: make sure to take your time".

>haunt closet
The closet slowly opens revealing some clothes and a jack-in-box.

The young boy wakes up wondering what is going on. The teddy bear immediately falls to the floor to avoid being noticed. 

[Your score has just gone up by one point.]

>look
Child's Bedroom
You can see a teddy bear, a wooden door, the open child's bed (under the covers of which is a confused young boy), a lamp and an open closet (in which are some clothes and a jack-in-box) here.

* * *

>in
You shimmer through to the Child's Bedroom.

Child's Bedroom
A typical kid's bedroom - all bright colours and optimism. You'd spit if you could. A small window paints a trapeziod of light over the young boy. There is a wooden door leading out.

You can see the child's bed (under the covers of which is a sleeping young boy), a lamp and a closet here.

The teddy bear waddles in from the Landing. The teddy bear whispers "It's worth giving a little thought to rule #2: make sure to take your time".

>haunt bed
As you haunt the child's bed, it starts to shake back and forth.

The young boy wakes up not quite sure of what's going on. The teddy bear immediately drops to the floor to evade suspicion. 

[Your score has just gone up by one point.]

>haunt bed
As you haunt the child's bed, it starts to shake back and forth.

The young boy screams. The young boy gets out of the child's bed.

The young boy runs off to the Landing, looking fairly scared.

[Your score has just gone up by one point.]

* * *

>out
You shimmer through to the Hallway.

Hallway
A mirror hangs on the wall here. "How incredibly vain the living are" you ponder for a few moments. A bedroom door leads back in to the master bedroom. The landing lies to the north.

You can see a pedestal (on which is a radio) here.

>haunt radio
The radio switches itself on and begins to cycle through channels seemingly at random.

The teddy bear waddles in from the Hallway.

[Your score has just gone up by three points.]

* * *

>z
Time passes.

>z
Time passes.

The teddy bear collapses to the floor in anticipation of someone coming. The young boy arrives from the north.

>z
Time passes.

With confused on his face, the young boy switches the radio off.

The young boy goes north.

>s
You can't go that way.

>showme boy
young boy - victim
location: in the child's bed in the Child's Bedroom
singular-named, improper-named; unlit, inedible, portable, unhauntable; male, active
list grouping key: none
printed name: "young boy"
printed plural name: "victims"
indefinite article: none
description: none
initial appearance: none
weirdness: none
carrying capacity: 100
quarters: Child's Bedroom
fear-state: confused

* * *

>z
Time passes.

With confused on his face, the young boy switches the radio off.

The young boy goes north.

>z
Time passes.

* * *

>z
Time passes.

With confused on his face, the young boy switches the radio off.

The young boy goes north.

>restart
Are you sure you want to restart?

>y
Scaring 101
An Interactive Fiction by Mikrokosmonaut
Release 1 / Serial number 181203 / Inform 7 build 6M62 (I6/v6.33 lib 6/12N) SD

Child's Bedroom
You can see a wooden door, the child's bed (under the covers of which is a sleeping young boy), a teddy bear, a lamp and a closet (empty) here.

>out
You shimmer through to the Landing.

Landing
You can see a wooden door here.

The teddy bear immediately falls to the floor to avoid being noticed.

* * *

>z
Time passes.

The teddy bear collapses to the floor in anticipation of someone coming. The young boy arrives from the north.

>restart
Are you sure you want to restart?

* * *

>y
Scaring 101
An Interactive Fiction by Mikrokosmonaut
Release 1 / Serial number 181203 / Inform 7 build 6M62 (I6/v6.33 lib 6/12N) SD

Child's Bedroom
You can see a wooden door, the child's bed (under the covers of which is a sleeping young boy), a teddy bear, a lamp and a closet (empty) here.

>restart
Are you sure you want to restart?

>y
Scaring 101
An Interactive Fiction by Mikrokosmonaut
Release 1 / Serial number 181203 / Inform 7 build 6M62 (I6/v6.33 lib 6/12N) SD

Master Bedroom
You can see a bedroom door, the king-sized bed (under the covers of which are a sleeping bearded man and a sleeping young woman), a TV and an alarm clock here.

>restart
Are you sure you want to restart?

* * *

>y
Scaring 101
An Interactive Fiction by Mikrokosmonaut
Release 1 / Serial number 181203 / Inform 7 build 6M62 (I6/v6.33 lib 6/12N) SD

Hallway
You can see a bedroom door, a mirror and a radio here.

>haunt radio
The radio switches itself on and begins to cycle through channels seemingly at random.

---

[Your score has just gone up by three points.]

* * *

>z
Time passes.

>look
Hallway
You can see a bearded man, a bedroom door, a teddy bear, a mirror and a radio here.

The teddy bear immediately falls to the floor to avoid being noticed. The bearded man switches the radio off.

The bearded man goes inside.

* * *

>haunt radio
The radio switches itself on and begins to cycle through channels seemingly at random.

The teddy bear waddles in from the Hallway.

[Your score has just gone up by three points.]

>in
You shimmer through to the Master Bedroom.

Master Bedroom
You can see a bedroom door, the king-sized bed (under the covers of which are a confused bearded man and a confused young woman), a TV and a bed-side table (on which is an alarm clock) here.

>out
You shimmer through to the Hallway.

Hallway
You can see a bedroom door, a teddy bear, a mirror and a pedestal (on which is a radio) here.

The young boy arrives from the Hallway, looking quite confused.

>n
You shimmer through to the Landing.

Landing
You can see a wooden door and a ball here.

The teddy bear waddles in from the Landing.

The teddy bear gets to his feet. The young boy arrives from the Landing, looking quite confused.

* * *

>z
Time passes.

The teddy bear immediately falls to the floor to avoid being noticed. The young boy gets back into the child's bed and pulls the covers over himself with a confused look on his face.

>z
Time passes.

>restart
Are you sure you want to restart?

>y
Scaring 101
An Interactive Fiction by Mikrokosmonaut
Release 1 / Serial number 181204 / Inform 7 build 6M62 (I6/v6.33 lib 6/12N) SD

Child's Bedroom
You can see a wooden door, the child's bed (under the covers of which is a sleeping young boy), a teddy bear, a lamp and a closet here.

>out
You shimmer through to the Landing.

Landing
You can see a wooden door and a ball here.

The teddy bear waddles in from the Landing.

>s
You shimmer through to the Hallway.

Hallway
You can see a bedroom door, a mirror and a pedestal (on which is a radio) here.

The teddy bear waddles in from the Hallway.

The teddy bear whispers "It's worth giving a little thought to rule #2: make sure to take your time".

>haunt radio
The radio switches itself on and begins to cycle through channels seemingly at random.

[Your score has just gone up by three points.]

>in
You shimmer through to the Master Bedroom.

Master Bedroom
You can see a bedroom door, the king-sized bed (under the covers of which are a confused bearded man and a confused young woman), a TV and a bed-side table (on which is an alarm clock) here.

* * *

>out
You shimmer through to the Hallway.

Hallway
A mirror hangs on the wall here. "How incredibly vain the living are" you ponder for a few moments. A bedroom door leads back in to the master bedroom. The landing lies to the north.

You can see a pedestal (on which is a radio) here.

>z
Time passes.

The teddy bear arrives from the north.

>z
Time passes.

* * *

>look
Hallway
You can see a teddy bear, a bedroom door, a mirror and a radio here.

>restart
Are you sure you want to restart?

* * *

>y
Scaring 101
An Interactive Fiction by Mikrokosmonaut
Release 1 / Serial number 181203 / Inform 7 build 6M62 (I6/v6.33 lib 6/12N) SD

Master Bedroom
You can see a bedroom door, the king-sized bed (under the covers of which are a sleeping bearded man and a sleeping young woman), a TV and an alarm clock here.

>out
You shimmer through to the Hallway.

Hallway
You can see a bedroom door, a mirror and a radio here.

>look
Hallway
You can see a bedroom door, a mirror and a radio here.

>look
Hallway
You can see a teddy bear, a bedroom door, a mirror and a radio here.

* * *

>z
Time passes.

The teddy bear arrives from the north.

>haunt radio
The radio switches itself on and begins to cycle through channels seemingly at random.

[Your score has just gone up by three points.]

>z
Time passes.

The teddy bear collapses to the floor in anticipation of someone coming. The bearded man arrives from the inside.

got here.

>z
Time passes.

The bearded man switches the radio off.

got here.

The bearded man goes inside.

>z
Time passes.

got here.
The teddy bear gets to his feet.

* * *

>out
You shimmer through to the Hallway.

Hallway
A mirror hangs on the wall here. "How incredibly vain the living are" you ponder for a few moments. A bedroom door leads back in to the master bedroom. The landing lies to the north.

You can see a pedestal (on which is a radio) here.

>showme teddy
teddy bear - toy
location: in the Landing
singular-named, improper-named; unlit, inedible, portable, unhauntable; male, active
list grouping key: none
printed name: "teddy bear"
printed plural name: "toys"
indefinite article: none
description: none
initial appearance: none
weirdness: none
carrying capacity: 100

* * *

>out
You shimmer through to the Hallway.

Hallway
A mirror hangs on the wall here. "How incredibly vain the living are" you ponder for a few moments. A bedroom door leads back in to the master bedroom. The landing lies to the north.

You can see a pedestal (on which is a radio) here.

>haunt mirror
(Easter Egg) The mirror displays the Windows ME logo. Just the thought is enough to make even a poltergeist shiver.

The teddy bear waddles in from the Landing. The teddy bear whispers "Don't forget rule #3: variety is vital to a good haunt".

[Your score has just gone up by one point.]

>haunt radio
The radio switches itself on and begins to cycle through channels seemingly at random.

[Your score has just gone up by three points.]

>z
Time passes.

The teddy bear collapses to the floor in anticipation of someone coming. The young woman arrives from the inside.

>haunt mirror
The mirror perverts the reflection of the young woman into the form of a demon.

The young woman screams. The young woman switches the radio off.

The young woman goes inside.

[Your score has just gone up by one point.]

* * *

>haunt mirror
(Easter Egg) The mirror displays the Windows ME logo. Just the thought is enough to make even a poltergeist shiver.

The teddy bear waddles in from the Landing. The teddy bear whispers "Don't forget rule #3: variety is vital to a good haunt".

[Your score has just gone up by one point.]

>haunt mirror
The mirror displays a rolling landscape of faces, each wrought in its own particular kind of suffering.

The teddy bear whispers "Don't forget rule #2: make sure to take your time".

* * *

>out
You shimmer through to the Hallway.

Hallway
A mirror hangs on the wall here. "How incredibly vain the living are" you ponder for a few moments. A bedroom door leads back in to the master bedroom. The landing lies to the north.

You can see a pedestal (on which is a radio) here.

>l
Landing
A framed family photo hangs on the wall. A wooden door leads back in to the Child's bedroom. The hallway itself continues south from here. There is a staircase leading down to the first floor, but all the fun (read horror) is up here.

You can see a teddy bear and a ball here.

>s
You shimmer through to the Hallway.

Hallway
You can see a bedroom door, a mirror and a pedestal (on which is a radio) here.

The teddy bear waddles in from the Landing.

* * *

>haunt lamp
The bulb of the lamp flickers on and off for a few seconds.

The young boy wakes up wondering what is going on. The teddy bear immediately falls to the floor to avoid being noticed. Looks like you're on your own now. The young boy switches the lamp off.

[Your score has just gone up by one point.]

>haunt bed
As you haunt the child's bed, it starts to shake back and forth.

The young boy jumps with a fright.

>look
Child's Bedroom
You can see a wooden door, the child's bed (in which is a scared young boy), a teddy bear and a lamp here.

>haunt door
You can't haunt the wooden door.

* * *

>haunt lamp
The bulb of the lamp flickers on and off for a few seconds.

The young boy wakes up wondering what is going on. The teddy bear immediately falls to the floor to avoid being noticed. Looks like you're on your own now. The young boy switches the lamp off.

[Your score has just gone up by one point.]

>look
Child's Bedroom
You can see a wooden door, the child's bed (under the covers of which is a confused young boy), a teddy bear, a lamp and a closet (empty) here.

>restart
Are you sure you want to restart?

>y
Scaring 101
An Interactive Fiction by Mikrokosmonaut
Release 1 / Serial number 181202 / Inform 7 build 6M62 (I6/v6.33 lib 6/12N) SD

Child's Bedroom
You can see a wooden door, the child's bed (under the covers of which is a sleeping young boy), a teddy bear, a lamp and a closet (empty) here.

>out
You shimmer through to the Landing.

Landing
You can see a wooden door here.

The teddy bear arrives from the inside.

>in
You shimmer through to the Child's Bedroom.

Child's Bedroom
You can see a wooden door, the child's bed (under the covers of which is a sleeping young boy), a lamp and a closet (empty) here.

The teddy bear arrives from the outside.

>x door
The wooden door is open.

>haunt lamp
The bulb of the lamp flickers on and off for a few seconds.

The young boy wakes up wondering what is going on.

Someone has woken up.

>look
Child's Bedroom
You can see a teddy bear, a wooden door, the child's bed (under the covers of which is a confused young boy), a lamp and a closet (empty) here.

>out
You shimmer through to the Landing.

Landing
You can see a wooden door here.

The teddy bear arrives from the inside.

>s
You shimmer through to the Hallway.

Hallway
You can see a bedroom door, a mirror and a radio here.

The teddy bear arrives from the north.

* * *

>look
Child's Bedroom
You can see a wooden door, the child's bed (under the covers of which is a confused young boy), a teddy bear, a lamp and a closet (empty) here.

>haunt lamp
The bulb of the lamp flickers on and off for a few seconds.

The young boy looks a little shaken. 

The young boy switches the lamp off.

[Your score has just gone up by one point.]

>haunt lamp
The bulb of the lamp flickers on and off for a few seconds.

The young boy looks unsettled enough as it is. 

The young boy switches the lamp off.

>haunt bed
As you haunt the child's bed, it starts to shake back and forth.

The young boy screams.

[Your score has just gone up by one point.]

>haunt door
The wooden door starts to rattle.

The young boy is too scared to notice.

>out
You shimmer through to the Landing.

Landing
You can see a wooden door here.

The teddy bear arrives from the inside.

* * *

>in
You shimmer through to the Master Bedroom.

Master Bedroom
You can see a bedroom door, the king-sized bed (under the covers of which are a sleeping bearded man and a sleeping young woman), a TV, an alarm clock and a large window here.

The teddy bear arrives from the outside.

>haunt door
The bedroom door starts to rattle.

The bearded man and the young woman wake up with a start. 

[Your score has just gone up by two points.]

>haunt tv
The TV switches itself on and begins to cycle through channels seemingly at random.

The bearded man and the young woman scream.

    *** Done! ***

In that game you scored 7 out of a possible 9, in 11 turns.

Would you like to RESTART, RESTORE a saved game, QUIT or UNDO the last command?

* * *

>haunt lamp
The bulb of the lamp flickers on and off for a few seconds.

The young boy wakes up wondering what is going on. The teddy bear immediately falls to the floor to avoid being noticed. Looks like you're on your own now. The young boy switches the lamp off.

[Your score has just gone up by one point.]

>out
You shimmer through to the Landing.

Landing
You can see a wooden door here.

The teddy bear arrives from the inside.

* * *

>in
You shimmer through to the Master Bedroom.

Master Bedroom
You can see a bedroom door, the king-sized bed (under the covers of which are a sleeping bearded man and a sleeping young woman), a TV, an alarm clock and a large window here.

The teddy bear arrives from the outside.

>haunt door
The bedroom door starts to rattle.

got here!

>look
Master Bedroom
You can see a teddy bear, a bedroom door, the king-sized bed (under the covers of which are a scared bearded man and a scared young woman), a TV, an alarm clock and a large window here.

* * *

>out
You shimmer through to the Landing.

Landing
You can see a wooden door here.

The teddy bear arrives from the inside.

>n
You shimmer through to the Landing.

Landing
You can see a wooden door and a teddy bear here.

>in
You shimmer through to the Child's Bedroom.

Child's Bedroom
You can see a wooden door, the child's bed (under the covers of which is a sleeping young boy), a lamp and a closet (empty) here.

The teddy bear arrives from the outside.

>haunt lamp
The bulb of the lamp flickers on and off for a few seconds.

The young boy wakes up wondering what is going on.

nothing screams.

Someone has woken up.

>out
You shimmer through to the Landing.

Landing
You can see a wooden door here.

The teddy bear arrives from the inside.

* * *

>s
You shimmer through to the Hallway.

Hallway
You can see a bedroom door, a mirror and a radio here.

The teddy bear arrives from the north.

>n
You shimmer through to the Landing.

Landing
You can see a wooden door here.

The teddy bear arrives from the south.

>s
You shimmer through to the Hallway.

Hallway
You can see a bedroom door, a mirror and a radio here.

The teddy bear arrives from the north.

* * *

>out
You shimmer through to the Landing.

Landing
You can see a wooden door here.

The teddy bear arrives from the inside.

>haunt door
The wooden door slams shut.

[Your score has just gone up by two points.]

>n
You can't go that way.

>s
You shimmer through to the Hallway.

Hallway
You can see a bedroom door, a mirror and a radio here.

The teddy bear arrives from the north.

>in
You shimmer through to the Master Bedroom.

Master Bedroom
You can see a bedroom door, the king-sized bed (under the covers of which are a confused bearded man and a confused young woman), a TV and an alarm clock here.

>haunt tv
The TV switches itself on and begins to cycle through channels seemingly at random.

The bearded man and the young woman scream.The bearded man switches the TV off.

[Your score has just gone up by two points.]

>haunt tv
The TV switches itself on and begins to cycle through channels seemingly at random.

The bearded man and the young woman scream.The bearded man switches the TV off.

* * *

>haunt lamp
The bulb of the lamp flickers on and off for a few seconds.

The young boy wakes up wondering what is going on. The teddy bear immediately falls to the floor to avoid being noticed. Looks like you're on your own now. The young boy switches the lamp off.

[Your score has just gone up by one point.]

>haunt tv
The TV switches itself on and begins to cycle through channels seemingly at random.

>out
You shimmer through to the Hallway.

Hallway
You can see a bedroom door, a mirror and a radio here.

The teddy bear arrives from the north.

>s
You can't go that way.

>n
You shimmer through to the Landing.

Landing
You can see a wooden door here.

The teddy bear arrives from the south.

>in
You shimmer through to the Child's Bedroom.

Child's Bedroom
You can see a wooden door, the child's bed (under the covers of which is a sleeping young boy), a lamp and a closet (empty) here.

The teddy bear arrives from the outside.

>haunt lamp
The bulb of the lamp flickers on and off for a few seconds.

The young boy wakes up wondering what is going on. The teddy bear immediately falls to the floor to avoid being noticed. Looks like you're on your own now. The young boy switches the lamp off.

[Your score has just gone up by one point.]

>haunt door
The wooden door slams shut.

The young boy jumps with fright. 

[Your score has just gone up by three points.]

* * *

>haunt door
The bedroom door slowly creaks open.

>haunt door
The wooden door violently slams shut.

[Your score has just gone up by three points.]

>look
Child's Bedroom
You can see a wooden door, the child's bed (in which is a suspicious young boy), a teddy bear and a lamp here.

* * *

>in
Child's Bedroom
You can see a wooden door, the child's bed (in which is a suspicious young boy) and a lamp here.

The teddy bear arrives from the outside.

>look
Child's Bedroom
You can see a teddy bear, a wooden door, the child's bed (in which is a suspicious young boy) and a lamp here.

* * *

>haunt door
The wooden door violently slams shut.

[Your score has just gone up by three points.]

>s
You shimmer through to the Hallway.

Hallway
You can see a bedroom door, a mirror and a pedestal (on which is a radio) here.

The teddy bear arrives from the north.

>n
You shimmer through to the Landing.

Landing
You can see a wooden door and a ball here.

The teddy bear arrives from the south.

>s
You shimmer through to the Hallway.

Hallway
You can see a bedroom door, a mirror and a pedestal (on which is a radio) here.

The teddy bear arrives from the north.

>in
You shimmer through to the Master Bedroom.

Master Bedroom
You can see a bedroom door, the king-sized bed (under the covers of which are a confused bearded man and a confused young woman), a TV and a bed-side table (on which is an alarm clock) here.

>haunt table
The bed-side table starts to shake aggressively causing the alarm clock to rattle.

The bearded man and the young woman look a little shaken. 

[Your score has just gone up by two points.]

>haunt table
The bed-side table starts to shake aggressively causing the alarm clock to rattle.

The bearded man and the young woman look unsettled enough as it is.

>haunt table
The bed-side table starts to shake aggressively causing the alarm clock to rattle.

The bearded man and the young woman look unsettled enough as it is.

>haunt table
The bed-side table starts to shake aggressively causing the alarm clock to rattle.

The bearded man and the young woman look unsettled enough as it is. The alarm clock falls to the floor.

* * *

>haunt door
The bedroom door slowly creaks open.

>look
Master Bedroom
You can see a bedroom door, the king-sized bed (under the covers of which are a confused bearded man and a confused young woman), a TV, an alarm clock and a large window here.

>haunt door
The wooden door starts to rattle.

The young boy looks as if he's starting to feel a little unsettled.

>l
Child's Bedroom
You can see a wooden door, the child's bed (in which is a unsettled young boy), a teddy bear, a lamp and a closet (empty) here.

>haunt door
The wooden door starts to rattle.

The young boy looks unsettled enough as it is.

>out
You shimmer through to the Landing.

Landing
You can see a wooden door here.

The teddy bear arrives from the inside.

>d
There's probably nobody down there to scare.

>s
You shimmer through to the Hallway.

Hallway
You can see a bedroom door, a mirror and a radio here.

The teddy bear arrives from the north.

>x door
The wooden door is closed.

>go door
You're a poltergeist. You're not in the business of entering.

>in
You shimmer through to the Master Bedroom.

Master Bedroom
You can see a bedroom door, the king-sized bed (in which is a sleeping bearded man), a TV, an alarm clock and a large window here.

The teddy bear arrives from the outside.

>haunt bed
As you haunt the king-sized bed, it starts to shake back and forth.

The bearded man jumps with a fright.
The young woman jumps with a fright.

>look
Master Bedroom
You can see a teddy bear, a bedroom door, the king-sized bed (in which is a scared bearded man), a TV, an alarm clock and a large window here.

>x woman
You see nothing special about the young woman.

>look
Master Bedroom
You can see a teddy bear, a bedroom door, the king-sized bed (in which is a scared bearded man), a TV, an alarm clock and a large window here.

* * *

>haunt door
The wooden door starts to rattle.

The young boy looks as if he's starting to feel a little unsettled.

>look
Child's Bedroom
You can see a wooden door, the child's bed (in which is an unsettled young boy), a teddy bear, a lamp and a closet (empty) here.

>out
You shimmer through to the Landing.

Landing
You can see a wooden door here.

The teddy bear arrives from the inside.

>haunt door
The wooden door starts to rattle.

>haunt door
The wooden door starts to rattle.

>in
You shimmer through to the Child's Bedroom.

Child's Bedroom
You can see a wooden door, the child's bed (in which is an unsettled young boy), a lamp and a closet (empty) here.

The teddy bear arrives from the outside.

>haunt door
The wooden door starts to rattle.

>look
Child's Bedroom
You can see a teddy bear, a wooden door, the child's bed (in which is a scared young boy), a lamp and a closet (empty) here.

>out
You shimmer through to the Landing.

Landing
You can see a wooden door here.

The teddy bear arrives from the inside.

* * *

>s
You shimmer through to the Hallway.

Hallway
You can see a bedroom door, a mirror and a radio here.

The teddy bear arrives from the north.

>in
You shimmer through to the Master Bedroom.

Master Bedroom
You can see a bedroom door, the king-sized bed (in which are a confused bearded man and a confused young woman), a TV, an alarm clock and a large window here.

The teddy bear arrives from the outside.

* * *

>look
Master Bedroom
You can see a bedroom door, the king-sized bed (under the covers of which are a confused bearded man and a confused young woman), a TV, an alarm clock and a large window here.

>haunt alarm
The alarm clock starts ringing suddenly and the sound slowly dies off as if it's just realised that it's out of power.

The bearded man and the young woman jump with fright.

The teddy bear arrives from the outside.

>out
You shimmer through to the Hallway.

Hallway
You can see a bedroom door, a mirror and a radio here.

The teddy bear arrives from the inside.

>s
You can't go that way.

* * *

>in
You shimmer through to the Child's Bedroom.

Child's Bedroom
You can see a wooden door, the child's bed (under the covers of which is a confused young boy), a lamp and a closet (empty) here.

The teddy bear arrives from the outside.

>haunt lamp
The bulb of the lamp flickers on and off for a few seconds.

The young boy looks a little shaken.

>look
Child's Bedroom
You can see a teddy bear, a wooden door, the child's bed (under the covers of which is an unsettled young boy), a lamp and a closet (empty) here.

>haunt closet
The closet shakes.

>look
Child's Bedroom
You can see a teddy bear, a wooden door, the child's bed (under the covers of which is an unsettled young boy), a lamp and a closet (empty) here.

>haunt door
The wooden door starts to rattle.

The young boy jumps with fright.

    *** Done! ***

Would you like to RESTART, RESTORE a saved game, QUIT or UNDO the last command?

* * *

>haunt door
The bedroom door slowly creaks open.

>restart
Are you sure you want to restart?

* * *

>in
You shimmer through to the Master Bedroom.

Master Bedroom
You can see a bedroom door, the king-sized bed (under the covers of which are a sleeping bearded man and a sleeping young woman), a TV, an alarm clock and a large window here.

The teddy bear arrives from the outside.

>haunt door
The bedroom door slams shut.

>look
Master Bedroom
You can see a teddy bear, a bedroom door, the king-sized bed (under the covers of which are a sleeping bearded man and a sleeping young woman), a TV, an alarm clock and a large window here.

* * *

>haunt door
The bedroom door slowly creaks open.

>haunt window
The large window starts to rattle.

The bearded man and the young woman look a little shaken. 

[Your score has just gone up by two points.]

>haunt alarm
The alarm clock suddenly starts ringing.

The bearded man and the young woman jump with fright. The young woman switches the alarm clock off.

[Your score has just gone up by three points.]

>out
You shimmer through to the Hallway.

Hallway
You can see a bedroom door, a teddy bear, a mirror and a radio here.

>s
You can't go that way.

* * *

>n
You shimmer through to the Landing.

Landing
You can see a wooden door here.

The teddy bear arrives from the south.

>in
You shimmer through to the Child's Bedroom.

Child's Bedroom
You can see a wooden door, the child's bed (under the covers of which is a confused young boy), a lamp and a closet (empty) here.

>haunt bed
As you haunt the child's bed, it starts to shake back and forth.

The young boy screams. 

    *** The teddy bear double-high fives you! ***

In that game you scored 8 out of a possible 9, in 8 turns.

Would you like to RESTART, RESTORE a saved game, QUIT or UNDO the last command?

>restart
Scaring 101
An Interactive Fiction by Mikrokosmonaut
Release 1 / Serial number 181203 / Inform 7 build 6M62 (I6/v6.33 lib 6/12N) SD

Landing
You can see a wooden door here.

>s
You shimmer through to the Hallway.

Hallway
You can see a bedroom door, a mirror and a radio here.

>in
You shimmer through to the Master Bedroom.

Master Bedroom
You can see a bedroom door, the king-sized bed (under the covers of which are a sleeping bearded man and a sleeping young woman), a TV and an alarm clock here.

>haunt alarm
The alarm clock suddenly starts ringing.

The bearded man and the young woman wake up with a start. The bearded man switches the alarm clock off.

[Your score has just gone up by three points.]

>haunt alarm
The alarm clock suddenly starts ringing.

The bearded man and the young woman jump with fright. The bearded man switches the alarm clock off.

[Your score has just gone up by two points.]

>haunt alarm
The alarm clock suddenly starts ringing.

The bearded man and the young woman jump with fright. The young woman switches the alarm clock off.

>haunt alarm
The alarm clock suddenly starts ringing.

The bearded man and the young woman jump with fright. The bearded man switches the alarm clock off.

>haunt door
The bedroom door rattles aggressively.

The bearded man and the young woman are too scared to notice.

* * *

>haunt door
The bedroom door slowly creaks open.

>in
You shimmer through to the Master Bedroom.

Master Bedroom
You can see a bedroom door, the king-sized bed (under the covers of which are a sleeping bearded man and a sleeping young woman), a TV and a bed-side table (on which is an alarm clock) here.

>haunt window
The large window starts to rattle.

The bearded man and the young woman wake up wondering what is going on. 

[Your score has just gone up by two points.]

>out
You shimmer through to the Hallway.

Hallway
You can see a bedroom door, a teddy bear, a mirror and a pedestal (on which is a radio) here.

The teddy bear whispers "Don't forget rule #1: always consider your surroundings".

>haunt radio
The radio switches itself on and begins to cycle through channels seemingly at random.

[Your score has just gone up by one point.]

>z
Time passes.

* * *

>z
Time passes.

The teddy bear collapses to the floor in anticipation of someone coming. The young boy arrives from the Landing, looking quite confused.

>z
Time passes.

With a confused look on his face, the young boy switches the radio off.

The young boy goes to the Landing, looking fairly confused.

>restart
Are you sure you want to restart?

* * *

>s
You shimmer through to the Hallway.

Hallway
You can see a bedroom door, a mirror and a pedestal (on which is a radio) here.

>in
You shimmer through to the Master Bedroom.

Master Bedroom
You can see a bedroom door, the king-sized bed (under the covers of which are a sleeping bearded man and a sleeping young woman), a TV and a bed-side table (on which is an alarm clock) here.

>z
Time passes.

The teddy bear waddles in from the Hallway.

The teddy bear whispers "Don't forget rule #1: always consider your surroundings".

>haunt window
The large window starts to rattle.

The bearded man and the young woman wake up wondering what is going on. The teddy bear immediately falls to the floor to avoid being noticed. 

[Your score has just gone up by two points.]

>z
Time passes.

>haunt window
The large window starts to rattle.

The bearded man and the young woman look a little shaken. 

[Your score has just gone up by two points.]

>out
You shimmer through to the Hallway.

Hallway
You can see a bedroom door, a mirror and a pedestal (on which is a radio) here.

The teddy bear waddles in from the Master Bedroom.

The teddy bear gets to his feet.

>haunt radio
The radio switches itself on and begins to cycle through channels seemingly at random.

[Your score has just gone up by one point.]

* * *

>x window
You can't see any such thing.

>haunt window
The large window starts to rattle.

The bearded man and the young woman wake up wondering what is going on. 

[Your score has just gone up by two points.]

>haunt door
The bedroom door rattles aggressively.

The bearded man and the young woman look a little shaken. 

[Your score has just gone up by two points.]

>haunt tv
The TV switches itself on and begins to cycle through channels seemingly at random.

The bearded man and the young woman scream.

The bearded man switches the TV off.

[Your score has just gone up by two points.]

>haunt alarm
The alarm clock suddenly starts ringing.

The bearded man and the young woman jump with fright.

The bearded man switches the alarm clock off.

[Your score has just gone up by one point.]

>out
You shimmer through to the Hallway.

Hallway
You can see a bedroom door, a teddy bear, a mirror and a radio here.

>n
You shimmer through to the Landing.

Landing
You can see a wooden door here.

The teddy bear arrives from the south.

* * *

>in
You shimmer through to the Child's Bedroom.

Child's Bedroom
You can see a wooden door, the child's bed (under the covers of which is a confused young boy), a lamp and a closet (empty) here.

>haunt lamp
The bulb of the lamp flickers on and off for a few seconds.

The young boy looks a little shaken. 

The young boy switches the lamp off.

[Your score has just gone up by one point.]

>haunt bed
As you haunt the child's bed, it starts to shake back and forth.

The young boy screams.

    *** Done! ***

In that game you scored 9 out of a possible 9, in 10 turns.

Would you like to RESTART, RESTORE a saved game, QUIT or UNDO the last command?

* * *

>x window
You can't see any such thing.

>in
You shimmer through to the Master Bedroom.

Master Bedroom
You can see a bedroom door, the king-sized bed (under the covers of which are a sleeping bearded man and a sleeping young woman), a TV and a bed-side table (on which is an alarm clock) here.

>x window
It's night outside. The best time for scaring.

>x window
It's night outside. The best time for scaring.

The teddy bear arrives from the outside.

>x alarm
The finer details of human possessions are of little interest to you.

The alarm clock is currently switched off.

* * *

>haunt closet
The closet slowly opens revealing some clothes and a jack-in-box.

The young boy wakes up wondering what is going on. The teddy bear immediately falls to the floor to avoid being noticed. 

[Your score has just gone up by one point.]

>haunt lamp
The bulb of the lamp flickers on and off for a few seconds.

The young boy wakes up wondering what is going on.

Someone has woken up.

* * *

>haunt closet
The closet slowly opens revealing some clothes and a jack-in-box.

The young boy wakes up wondering what is going on. The teddy bear immediately falls to the floor to avoid being noticed. 

[Your score has just gone up by one point.]

>haunt teddy
You can't haunt the teddy bear.

>haunt window
The window starts to rattle.

* * *

>haunt closet
The closet slowly opens revealing some clothes and a jack-in-box.

The young boy wakes up wondering what is going on. The teddy bear immediately falls to the floor to avoid being noticed. 

[Your score has just gone up by one point.]

>look
Child's Bedroom
You can see a wooden door, the child's bed (in which is a suspicious young boy), a teddy bear, a lamp and a closet (empty) here.

* * *

>haunt closet
The closet slowly opens revealing some clothes and a jack-in-box.

The young boy wakes up wondering what is going on. The teddy bear immediately falls to the floor to avoid being noticed. 

[Your score has just gone up by one point.]

>haunt clothes
The clothes fly out of the closet in all directions.

The young boy screams. 

[Your score has just gone up by one point.]

>look
Child's Bedroom
You can see some scattered clothes, a wooden door, the child's bed (under the covers of which is a scared young boy), a teddy bear, a lamp and a closet (in which is a jack-in-box) here.

>x scattered clothes
You see nothing special about the scattered clothes.

>haunt jack-in-box
The little handle on the side of the jack-in-box starts to wind ever so slowly... all of a sudden the jack-in-box springs to life with a laugh so spiteful, you wonder why anyone would've chosen it for a children's toy.

The young boy screams.

>haunt jack-in-box
The little handle on the side of the jack-in-box starts to wind ever so slowly... all of a sudden the jack-in-box springs to life with a laugh so spiteful, you wonder why anyone would've chosen it for a children's toy.

The young boy screams.

* * *

>haunt closet
The closet slowly opens revealing some clothes and a jack-in-box.

The young boy wakes up wondering what is going on. The teddy bear immediately falls to the floor to avoid being noticed. 

[Your score has just gone up by one point.]

>haunt jack-in-box
The little handle on the side of the jack-in-box starts to wind ever so slowly... all of a sudden the jack-in-box springs to life with a laugh so spiteful, you wonder why anyone would've chosen it for a children's toy.

The young boy screams. 

[Your score has just gone up by one point.]

>haunt jack-in-box
The jack-in-box starts to bend in all directions, laughing in that deliciously hideous way you've come to appreciate.

The young boy screams.

>haunt jack-in-box
The jack-in-box starts to bend in all directions, laughing in that deliciously hideous way you've come to appreciate.

The young boy screams.

* * *

>haunt closet
The closet slowly opens revealing some clothes and a jack-in-box.

The young boy wakes up wondering what is going on. The teddy bear immediately falls to the floor to avoid being noticed. 

[Your score has just gone up by one point.]

>haunt window
The small window starts to rattle.

The young boy looks a little shaken. 

[Your score has just gone up by one point.]

>haunt lamp
The bulb of the lamp flickers on and off for a few seconds.

The young boy looks unsettled enough as it is. With an unsettled look on his face, the young boy switches the lamp off.

>haunt jack-in-box
The little handle on the side of the jack-in-box starts to wind ever so slowly... all of a sudden the jack-in-box springs to life with a laugh so spiteful, you wonder why anyone would've chosen it for a children's toy.

The young boy screams. 

[Your score has just gone up by one point.]

>haunt door
The wooden door slowly creaks open.

The young boy is scared enough as it is.

>haunt door
The wooden door violently slams shut.

The young boy jumps with fright. 

[Your score has just gone up by two points.]

>out
You shimmer through to the The Landing.

The Landing
You can see a wooden door and a ball here.

The teddy bear quietly crawls out from the The Child's Bedroom. The teddy bear gets to his feet.

>s
You shimmer through to the The Hallway.

The Hallway
You can see a bedroom door, a mirror and a pedestal (on which is a radio) here.

The teddy bear waddles in from the The Landing.

>haunt radio
The radio switches itself on and begins to cycle through channels seemingly at random.

>z
Time passes.

The teddy bear collapses to the floor in anticipation of someone coming. The young woman arrives from the The Master Bedroom, looking quite confused.

>haunt ball
You can't see any such thing.

>haunt pedestal
The pedestal starts to shake aggressively causing the radio to rattle.

The young woman looks a little shaken. With an unsettled look on her face, the young woman switches the radio off.

The young woman goes to the The Master Bedroom, looking fairly unsettled.

[Your score has just gone up by one point.]

>in
You shimmer through to the The Master Bedroom.

The Master Bedroom
You can see a bedroom door, a young woman, the king-sized bed (under the covers of which is a confused bearded man), a TV and a bed-side table (on which is an alarm clock) here.

The young woman gets back into the king-sized bed and pulls the covers over herself with an unsettled look on her face.

>haunt window
The large window starts to rattle.

The bearded man looks a little shaken. The young woman looks unsettled enough as it is. 

[Your score has just gone up by one point.]

>haunt window
The large window starts to rattle.

The bearded man and the young woman look unsettled enough as it is.

>haunt tv
The TV switches itself on and begins to cycle through channels seemingly at random.

The bearded man and the young woman scream. 

    *** The teddy bear double-high fives you! ***

In that game you scored 9 out of a possible 10, in 15 turns.

Would you like to RESTART, RESTORE a saved game, QUIT or UNDO the last command?

>undo
The Master Bedroom
[Previous turn undone.]

>out
You shimmer through to the The Hallway.

The Hallway
You can see a bedroom door, a teddy bear, a mirror and a pedestal (on which is a radio) here.

>haunt mirror
The mirror displays a rolling landscape of faces, each stretched out in its own kind of suffering.

[Your score has just gone up by one point.]

>restart
Are you sure you want to restart?

>y
Scaring 101
An Interactive Fiction by Mikrokosmonaut
Release 1 / Serial number 181204 / Inform 7 build 6M62 (I6/v6.33 lib 6/12N) SD

The Child's Bedroom
You can see a wooden door, the child's bed (under the covers of which is a sleeping young boy), a teddy bear, a lamp and a closet here.

>out
You shimmer through to the The Landing.

The Landing
You can see a wooden door and a ball here.

The teddy bear waddles in from the The Child's Bedroom. The teddy bear whispers "Don't forget rule #2: make sure to take your time".

>s
You shimmer through to the The Hallway.

The Hallway
You can see a bedroom door, a mirror and a pedestal (on which is a radio) here.

The teddy bear waddles in from the The Landing.

>haunt mirror
The mirror displays a rolling landscape of faces, each stretched out in its own kind of suffering.

[Your score has just gone up by one point.]

>haunt mirror
The mirror displays a rolling landscape of faces, each stretched out in its own kind of suffering.

* * *

>haunt window
The small window starts to rattle.

The young boy wakes up wondering what is going on.

Someone has woken up.

* * *

>z
Time passes.

The teddy bear arrives from the inside.

>z
Time passes.

>z
Time passes.

The teddy bear whispers "It's worth giving a little thought to rule #3: variety is key to a good haunt".

>z
Time passes.

>haunt radio
The radio switches itself on and begins to cycle through channels seemingly at random.

The teddy bear says "Wassup?

[Your score has just gone up by three points.]

>z
Time passes.

The teddy bear says "Wassup?

>z
Time passes.

The teddy bear collapses to the floor in anticipation of someone coming. The young boy arrives from the north.

* * *

>z
Time passes.

The young boy switches the radio off.

The young boy goes north.

>z
Time passes.

The teddy bear gets to his feet. 

The teddy bear says "Wassup?

* * *

>z
Time passes.

>z
Time passes.

"It's worth giving a little thought to rule #1: always consider your surroundings." whispers the teddy bear.

* * *

>z
Time passes.

>haunt door
The bedroom door starts to rattle.

bearded man and young woman wakes up wondering what is going on.

Someone has woken up.

The teddy bear arrives from the outside.

* * *

>z
Time passes.

>in
You shimmer through to the Master Bedroom.

Master Bedroom
You can see a bedroom door, the king-sized bed (under the covers of which are a sleeping bearded man and a sleeping young woman), a TV and an alarm clock here.

The teddy bear arrives from the outside.

>haunt window
The large window starts to rattle.

The bearded man and the young woman wake up wondering what is going on. The teddy bear immediately falls to the floor to avoid being noticed - looks like you're on your own now. 

[Your score has just gone up by two points.]

>look
Master Bedroom
You can see a teddy bear, a bedroom door, the king-sized bed (under the covers of which are a confused bearded man and a confused young woman), a TV and an alarm clock here.

>haunt alarm
The alarm clock suddenly starts ringing.

The bearded man and the young woman jump with fright. The bearded man switches the alarm clock off.

[Your score has just gone up by three points.]

>out
You shimmer through to the Hallway.

Hallway
You can see a bedroom door, a mirror and a radio here.

The teddy bear arrives from the inside.

* * *

>haunt lamp
The bulb of the lamp flickers on and off for a few seconds.

The young boy looks a little shaken. The young boy switches the lamp off.

[Your score has just gone up by one point.]

>haunt bed
As you haunt the child's bed, it starts to shake back and forth.

The young boy screams. 

    *** Done! ***

In that game you scored 7 out of a possible 9, in 11 turns.

Would you like to RESTART, RESTORE a saved game, QUIT or UNDO the last command?

* * *

I beg your pardon?

>z
Time passes.

* * *

>in
You shimmer through to the Master Bedroom.

Master Bedroom
You can see a bedroom door, the king-sized bed (under the covers of which are a sleeping bearded man and a sleeping young woman), a TV, an alarm clock and a large window here.

The teddy bear arrives from the outside.

>haunt door
The bedroom door starts to rattle.

The bearded man and the young woman wake up with a start. 

Someone has woken up.

>look
Master Bedroom
You can see a teddy bear, a bedroom door, the king-sized bed (under the covers of which are a scared bearded man and a scared young woman), a TV, an alarm clock and a large window here.

>restart
Are you sure you want to restart?

* * *

>y
Scaring 101
An Interactive Fiction by Mikrokosmonaut
Release 1 / Serial number 181202 / Inform 7 build 6M62 (I6/v6.33 lib 6/12N) SD

Landing
You can see a wooden door here.

>n
You can't go that way.

The teddy bear arrives from the inside.

* * *

>haunt door
The bedroom door starts to rattle.

The bearded man and the young woman wake up with a start. 

Someone has woken up.

>out
You shimmer through to the Hallway.

Hallway
You can see a bedroom door, a mirror and a radio here.

The teddy bear arrives from the inside.

* * *

>z
Time passes.

The teddy bear arrives from the inside.

>look
Landing
You can see a teddy bear and a wooden door here.

>x door
The wooden door is open.

>s
You shimmer through to the Hallway.

Hallway
You can see a bedroom door, a mirror and a radio here.

The teddy bear arrives from the north.

* * *

>in
You shimmer through to the Master Bedroom.

Master Bedroom
You can see a bedroom door, the king-sized bed (under the covers of which are a sleeping bearded man and a sleeping young woman), a TV, an alarm clock and a large window here.

The teddy bear arrives from the outside.

>out
You shimmer through to the Hallway.

Hallway
You can see a bedroom door, a mirror and a radio here.

The teddy bear arrives from the inside.

* * *

>in
You shimmer through to the Child's Bedroom.

Child's Bedroom
You can see a wooden door, the child's bed (under the covers of which is a sleeping young boy), a lamp and a closet (empty) here.

The teddy bear arrives from the outside.

>haunt lamp
The bulb of the lamp flickers on and off for a few seconds.

The young boy wakes up wondering what is going on. 

The young boy switches the lamp off.

[Your score has just gone up by one point.]

>haunt lamp
The bulb of the lamp flickers on and off for a few seconds.

The young boy looks a little shaken. 

The young boy switches the lamp off.

[Your score has just gone up by one point.]

>haunt door
The wooden door starts to rattle.

The young boy jumps with fright.

[Your score has just gone up by three points.]

>out
You shimmer through to the Landing.

Landing
You can see a wooden door here.

The teddy bear arrives from the inside.

* * *

>s
You shimmer through to the Hallway.

Hallway
You can see a bedroom door, a mirror and a radio here.

The teddy bear arrives from the north.

>in
You shimmer through to the Master Bedroom.

Master Bedroom
You can see a bedroom door, the king-sized bed (under the covers of which are a confused bearded man and a confused young woman), a TV, an alarm clock and a large window here.

>haunt door
The bedroom door starts to rattle.

The bearded man and the young woman jump with fright.

    *** Done! ***

In that game you scored 7 out of a possible 9, in 16 turns.

Would you like to RESTART, RESTORE a saved game, QUIT or UNDO the last command?

* * *

>in
You shimmer through to the Child's Bedroom.

Child's Bedroom
A typical kid's bedroom - all bright colours and optimism. You'd spit if you could. A small window paints a trapeziod of light over the young boy. There is a wooden door leading out.

You can see the child's bed (under the covers of which is a sleeping young boy), a teddy bear with a bored look on his face, a lamp and a closet here.

"Psst! It's me" hisses your plush companion.

>haunt lamp
The lamp flickers on and off randomly for a few seconds.

The young boy wakes up wondering what is going on. The teddy bear immediately collapses to the floor to evade suspicion. With a confused look on his face, the young boy switches the lamp off.

[Your score has just gone up by one point.]

>out
You shimmer through to the Landing.

Landing
You can see a wooden door here.

The teddy bear arrives from the inside.

* * *

>haunt lamp
The lamp flickers on and off randomly for a few seconds.

The young boy wakes up wondering what is going on. The teddy bear immediately collapses to the floor to evade suspicion. With a confused look on his face, the young boy switches the lamp off.

[Your score has just gone up by one point.]

>haunt lamp
The bulb of the lamp flickers on and off for a few seconds.

The young boy looks a little shaken. The young boy switches the lamp off.

[Your score has just gone up by one point.]

>haunt lamp
The bulb of the lamp flickers on and off for a few seconds.

The young boy looks unsettled enough as it is. The young boy switches the lamp off.

>haunt closet
The closet shakes.

>haunt bed
As you haunt the child's bed, it starts to shake back and forth.

The young boy screams. 

[Your score has just gone up by one point.]

>out
You shimmer through to the Landing.

Landing
You can see a wooden door here.

The teddy bear arrives from the inside.

* * *

>haunt door
The wooden door slams shut.

[Your score has just gone up by two points.]

>s
You shimmer through to the Hallway.

Hallway
You can see a bedroom door, a mirror and a radio here.

The teddy bear arrives from the north.

* * *

>in
You shimmer through to the Master Bedroom.

Master Bedroom
You can see a bedroom door, the king-sized bed (under the covers of which are a confused bearded man and a confused young woman), a TV and an alarm clock here.

>haunt door
The bedroom door rattles aggressively.

The bearded man and the young woman look a little shaken. 

[Your score has just gone up by two points.]

>haunt tv
The TV switches itself on and begins to cycle through channels seemingly at random.

The bearded man and the young woman scream. 

    *** Done! ***

In that game you scored 9 out of a possible 9, in 12 turns.

Would you like to RESTART, RESTORE a saved game, QUIT or UNDO the last command?

* * *

>haunt lamp
The lamp flickers on and off randomly for a few seconds.

The young boy wakes up wondering what is going on. The teddy bear immediately collapses to the floor to evade suspicion. With a confused look on his face, the young boy switches the lamp off.

[Your score has just gone up by one point.]

>haunt bed
As you haunt the child's bed, it starts to shake back and forth.

The young boy screams. The young boy leaps out of nothing.

The young boy runs off into the Landing, looking fairly scared.

[Your score has just gone up by one point.]

>out
You shimmer through to the Landing.

Landing
A framed family photo hangs on the wall. A wooden door leads back in to the child's bedroom. The hallway itself continues south from here and while there is a staircase leading down to the first floor, all the fun is up here.

You can see a young boy and a ball here.

The young boy runs off into the Hallway, looking fairly scared.

>s
You shimmer through to the Hallway.

Hallway
A mirror hangs on the wall here. "How incredibly vain the living are" you ponder for a few moments. A bedroom door leads in to the master bedroom. The landing lies to the north.

You can see a young boy and a pedestal (on which is a radio) here.

The young boy runs off into the Master Bedroom, looking fairly scared.

>haunt mirror
(Easter Egg) The mirror displays the Windows ME logo. Just the thought is enough to make even a poltergeist shiver.

The teddy bear waddles in from the Landing. 

[Your score has just gone up by one point.]

>in
You shimmer through to the Master Bedroom.

Master Bedroom
Moonlight shines in through the large window, the shadow of the frame artificially segmenting the man and woman as if silently commenting on the state of their marriage.  A bedroom door leads back out to the hallway. 

You can see the king-sized bed (under the covers of which are a scared young boy, a sleeping bearded man and a sleeping young woman), a TV and a bed-side table (on which are an alarm clock and a flashlight) here.

>haunt bed
As you haunt the king-sized bed, it starts to shake back and forth.

The bearded man and the young woman wake up not quite sure of what's going on. The young boy screams. 

[Your score has just gone up by two points.]

>haunt bed
As you haunt the king-sized bed, it starts to shake back and forth.

The young boy, the bearded man and the young woman scream. 

    *** After scaring the poor family half to death, you decide to return to the ether before you do any serious damage.

What a night! Maybe this being dead thing business isn't as dull as you'd initially suspected. As you shimmer outside preparing to leave, the teddy bear catches you up. "Personally, I'd give you a B" he comments, only half-jokingly. "I think you're really starting to get the hang of haunting." he says encouragingly. "You just need to take things a little more gradually." Great job! ***

In that game you scored 7 out of a possible 10, in 9 turns.

Would you like to RESTART, RESTORE a saved game, QUIT or UNDO the last command?

>restart
Thursday night. Thursday, a concept that means very little to the recently deceased, which you most certainly are; and night, which as it turns out, is quickly becoming your favourite part of whole night-day dichotomy.

Haunting is on the cards for this particular evening. The supernatural, as it happens, is perfectly natural - common even. You've chosen a typical suburban house inhabited by a small family for the occasion. Your aim - confuse them, creep them out and scare them silly!

You're still new to this whole possession malarky, but an undead buddy of yours has kindly agreed to come along to offer pointers here and there. He said he'd meet you there.

Hint: To possess an item, try '>haunt the window' or '>haunt the lamp'.

Landing
A framed family photo hangs on the wall. "The illusion of permanence" you think to yourself. A wooden door leads in to the child's bedroom. The hallway itself continues south from here and while there is a staircase leading down to the first floor, all the fun (read horror) is up here.

You can see a ball here.

Scaring 101
An Interactive Fiction by Mikrokosmonaut
Release 1 / Serial number 181205 / Inform 7 build 6M62 (I6/v6.33 lib 6/12N) SD

Landing
A framed family photo hangs on the wall. A wooden door leads in to the child's bedroom. The hallway itself continues south from here and while there is a staircase leading down to the first floor, all the fun is up here.

You can see a ball here.

>in
You shimmer through to the Child's Bedroom.

Child's Bedroom
A typical kid's bedroom - all bright colours and optimism. You'd spit if you could. A small window paints a trapeziod of light over the young boy. There is a wooden door leading out.

You can see the child's bed (under the covers of which is a sleeping young boy), a teddy bear with a bored look on his face, a lamp and a closet here.

"Psst! It's me" hisses your plush companion.

>haunt lamp
The lamp flickers on and off randomly for a few seconds.

The young boy wakes up wondering what is going on. The teddy bear immediately drops to the floor to avoid being noticed. With a confused look on his face, the young boy switches the lamp off.

[Your score has just gone up by one point.]

>haunt lamp
The lamp flickers on and off randomly for a few seconds.

The young boy looks a little shaken. With an unsettled look on his face, the young boy switches the lamp off.

[Your score has just gone up by one point.]

>haunt bed
As you haunt the child's bed, it starts to shake back and forth.

The young boy screams. The young boy leaps out of nothing.

The young boy runs off into the Landing, looking fairly scared.

[Your score has just gone up by one point.]

* * *

>haunt bed
As you haunt the king-sized bed, it starts to shake back and forth.

The bearded man and the young woman wake up not quite sure of what's going on. The young boy screams. 

[Your score has just gone up by two points.]

>haunt bed
As you haunt the king-sized bed, it starts to shake back and forth.

The young boy, the bearded man and the young woman scream. 

    *** After scaring the poor family half to death, you decide to return to the ether before you do any serious damage.

What a night! Maybe this being dead thing business isn't as dull as you'd initially suspected. As you shimmer outside preparing to leave, the teddy bear catches you up. "Personally, I'd give you an A-" he comments, only half-jokingly. "What a haunt! You're gonna fit in just fine!" he says encouragingly. Way to go! ***

In that game you scored 8 out of a possible 10, in 10 turns.

Would you like to RESTART, RESTORE a saved game, QUIT or UNDO the last command?

>restart
Thursday night. Thursday, a concept that means very little to the recently deceased, which you most certainly are; and night, which as it turns out, is quickly becoming your favourite part of whole night-day dichotomy.

Haunting is on the cards for this particular evening. The supernatural, as it happens, is perfectly natural - common even. You've chosen a typical suburban house inhabited by a small family for the occasion. Your aim - confuse them, creep them out and scare them silly!

You're still new to this whole possession malarky, but an undead buddy of yours has kindly agreed to come along to offer pointers here and there. He said he'd meet you there.

Hint: To possess an item, try '>haunt the window' or '>haunt the lamp'.

Landing
A framed family photo hangs on the wall. "The illusion of permanence" you think to yourself. A wooden door leads in to the child's bedroom. The hallway itself continues south from here and while there is a staircase leading down to the first floor, all the fun (read horror) is up here.

You can see a ball here.

Scaring 101
An Interactive Fiction by Mikrokosmonaut
Release 1 / Serial number 181205 / Inform 7 build 6M62 (I6/v6.33 lib 6/12N) SD

Landing
A framed family photo hangs on the wall. A wooden door leads in to the child's bedroom. The hallway itself continues south from here and while there is a staircase leading down to the first floor, all the fun is up here.

You can see a ball here.

* * *

>in
You shimmer through to the Child's Bedroom.

Child's Bedroom
A typical kid's bedroom - all bright colours and optimism. You'd spit if you could. A small window paints a trapeziod of light over the young boy. There is a wooden door leading out.

You can see the child's bed (under the covers of which is a sleeping young boy), a teddy bear with a bored look on his face, a lamp and a closet here.

"Psst! It's me" hisses your plush companion.

>haunt lamp
The lamp flickers on and off randomly for a few seconds.

The young boy wakes up wondering what is going on. The teddy bear immediately collapses to the floor to avoid being noticed. With a confused look on his face, the young boy switches the lamp off.

[Your score has just gone up by one point.]

>haunt lamp
The lamp flickers on and off randomly for a few seconds.

The young boy looks a little shaken. With an unsettled look on his face, the young boy switches the lamp off.

[Your score has just gone up by one point.]

* * *

>s
You shimmer through to the Hallway.

Hallway
A mirror hangs on the wall here. "How incredibly vain the living are" you ponder for a few moments. A bedroom door leads in to the master bedroom. The landing lies to the north.

You can see a young boy and a pedestal (on which is a radio) here.

The young boy runs off into the Master Bedroom, looking fairly scared.

>in
You shimmer through to the Master Bedroom.

Master Bedroom
Moonlight shines in through the large window, the shadow of the frame artificially segmenting the man and woman as if silently commenting on the state of their marriage.  A bedroom door leads back out to the hallway. 

You can see a young boy, the king-sized bed (under the covers of which are a sleeping bearded man and a sleeping young woman), a TV and a bed-side table (on which are an alarm clock and a flashlight) here.

The young boy gets into the king-sized bed and pulls the covers over himself with a scared look on his face.

>haunt flashlight
The flashlight flickers on and off randomly for a few seconds.

The bearded man and the young woman wake up wondering what is going on. The young boy is scared enough as it is. With a confused look on her face, the young woman switches the flashlight off.

[Your score has just gone up by two points.]

>haunt flashlight
The flashlight flickers on and off randomly for a few seconds.

The bearded man and the young woman look a little shaken. The young boy is scared enough as it is. With an unsettled look on her face, the young woman switches the flashlight off.

[Your score has just gone up by two points.]

>out
You shimmer through to the Hallway.

Hallway
A mirror hangs on the wall here. A bedroom door leads back in to the master bedroom. The landing lies to the north.

You can see a teddy bear and a pedestal (on which is a radio) here.

>haunt mirror
(Easter Egg) The mirror displays the Windows ME logo. Just the thought is enough to make even a poltergeist shiver.

The teddy bear whispers "It's worth giving a little thought to rule #1: always consider your surroundings".

[Your score has just gone up by one point.]

>in
You shimmer through to the Master Bedroom.

Master Bedroom
Moonlight shines in through the large window, the shadow of the frame artificially segmenting the man and woman as if silently commenting on the state of their marriage.  A bedroom door leads back out to the hallway. 

You can see the king-sized bed (under the covers of which are a scared young boy, an unsettled bearded man and an unsettled young woman), a TV and a bed-side table (on which are an alarm clock and a flashlight) here.

>haunt bed
As you haunt the king-sized bed, it starts to shake back and forth.

The young boy, the bearded man and the young woman scream. 

    *** After scaring the poor family half to death, you decide to return to the ether before you do any serious damage.

What a night! Maybe this being dead thing business isn't as dull as you'd initially suspected. As you shimmer outside preparing to leave, the teddy bear catches you up. "Personally, I'd give you an A+" he comments, only half-jokingly. "What a haunt! I could probably learn a few things from you" is his final verdict. Double high fives! ***

In that game you scored 10 out of a possible 10, in 13 turns.

Would you like to RESTART, RESTORE a saved game, QUIT or UNDO the last command?

>restart
Thursday night. Thursday, a concept that means very little to the recently deceased, which you most certainly are; and night, which as it turns out, is quickly becoming your favourite part of whole night-day dichotomy.

Haunting is on the cards for this particular evening. The supernatural, as it happens, is perfectly natural - common even. You've chosen a typical suburban house inhabited by a small family for the occasion. Your aim - confuse them, creep them out and scare them silly!

You're still new to this whole possession malarky, but an undead buddy of yours has kindly agreed to come along to offer pointers here and there. He said he'd meet you there.

Hint: To possess an item, try '>haunt the window' or '>haunt the lamp'.

Landing
A framed family photo hangs on the wall. "The illusion of permanence" you think to yourself. A wooden door leads in to the child's bedroom. The hallway itself continues south from here and while there is a staircase leading down to the first floor, all the fun (read horror) is up here.

You can see a ball here.

Scaring 101
An Interactive Fiction by Mikrokosmonaut
Release 1 / Serial number 181205 / Inform 7 build 6M62 (I6/v6.33 lib 6/12N) SD

Landing
A framed family photo hangs on the wall. A wooden door leads in to the child's bedroom. The hallway itself continues south from here and while there is a staircase leading down to the first floor, all the fun is up here.

You can see a ball here.

>in
You shimmer through to the Child's Bedroom.

Child's Bedroom
A typical kid's bedroom - all bright colours and optimism. You'd spit if you could. A small window paints a trapeziod of light over the young boy. There is a wooden door leading out.

You can see the child's bed (under the covers of which is a sleeping young boy), a teddy bear with a bored look on his face, a lamp and a closet here.

"Psst! It's me" hisses your plush companion.

The teddy bear whispers "Keep in mind rule #2: make sure to take your time".

>haunt lamp
The lamp flickers on and off randomly for a few seconds.

The young boy wakes up wondering what is going on. The teddy bear immediately collapses to the floor to evade suspicion. With a confused look on his face, the young boy switches the lamp off.

[Your score has just gone up by one point.]

>haunt lamp
The lamp flickers on and off randomly for a few seconds.

The young boy looks a little shaken. With an unsettled look on his face, the young boy switches the lamp off.

[Your score has just gone up by one point.]

>haunt closer
You can't see any such thing.

>haunt closet
The closet slowly opens revealing some clothes and a jack-in-box.

The young boy looks unsettled enough as it is.

>haunt closet
The open closet closes with a slam.

The young boy jumps with fright. The young boy leaps out of nothing.

The young boy runs off into the Landing, looking fairly scared.

[Your score has just gone up by three points.]

>out
You shimmer through to the Landing.

Landing
A framed family photo hangs on the wall. A wooden door leads back in to the child's bedroom. The hallway itself continues south from here and while there is a staircase leading down to the first floor, all the fun is up here.

You can see a young boy and a ball here.

The young boy runs off into the Hallway, looking fairly scared.

>n
You can't go that way.

The teddy bear waddles in from the Child's Bedroom.

>s
You shimmer through to the Hallway.

Hallway
A mirror hangs on the wall here. "How incredibly vain the living are" you ponder for a few moments. A bedroom door leads in to the master bedroom. The landing lies to the north.

You can see a pedestal (on which is a radio) here.

The teddy bear waddles in from the Landing.

>in
You shimmer through to the Master Bedroom.

Master Bedroom
Moonlight shines in through the large window, the shadow of the frame artificially segmenting the man and woman as if silently commenting on the state of their marriage.  A bedroom door leads back out to the hallway. 

You can see the king-sized bed (under the covers of which are a scared young boy, a confused bearded man and a confused young woman), a TV and a bed-side table (on which are an alarm clock and a flashlight) here.

>haunt bed
As you haunt the king-sized bed, it starts to shake back and forth.

The young boy, the bearded man and the young woman scream. 

    *** After scaring the poor family half to death, you decide to return to the ether before you do any serious damage.

What a night! Maybe this being dead thing business isn't as dull as you'd initially suspected. As you shimmer outside preparing to leave, the teddy bear catches you up. "Personally, I'd give you a B" he comments, only half-jokingly. "I think you're really starting to get the hang of haunting." he says encouragingly. "You just need to take things a little more gradually." Great job! ***

In that game you scored 7 out of a possible 10, in 10 turns.

Would you like to RESTART, RESTORE a saved game, QUIT or UNDO the last command?

>undo
Master Bedroom
[Previous turn undone.]

>haunt flashlight
The flashlight flickers on and off randomly for a few seconds.

The bearded man and the young woman look a little shaken. The young boy is scared enough as it is. With an unsettled look on her face, the young woman switches the flashlight off.

[Your score has just gone up by two points.]

>haunt bed
As you haunt the king-sized bed, it starts to shake back and forth.

The young boy, the bearded man and the young woman scream. 

    *** After scaring the poor family half to death, you decide to return to the ether before you do any serious damage.

What a night! Maybe this being dead thing business isn't as dull as you'd initially suspected. As you shimmer outside preparing to leave, the teddy bear catches you up. "Personally, I'd give you an A" he comments, only half-jokingly. "That was some quality scaring! I really like how you haunt." he tells you "Let's do this again some time!" High five! ***

In that game you scored 9 out of a possible 10, in 11 turns.

Would you like to RESTART, RESTORE a saved game, QUIT or UNDO the last command?

* * *

>in
You shimmer through to the Child's Bedroom.

Child's Bedroom
A typical kid's bedroom - all bright colours and optimism. You'd spit if you could. A small window paints a trapeziod of light over the young boy. There is a wooden door leading out.

You can see the child's bed (under the covers of which is a sleeping young boy), a teddy bear with a bored look on his face, a lamp and a closet here.

"Psst! It's me" hisses your plush companion.

>haunt door
The bedroom door starts to rattle.

The bearded man and the young woman wake up wondering what is going on. 

[Your score has just gone up by two points.]

>z
Time passes.

>haunt door
The bedroom door starts to rattle.

>haunt bed
As you haunt the king-sized bed, it starts to shake back and forth.

The bearded man jumps with fright.
The young woman jumps with fright.

>haunt bed
As you haunt the king-sized bed, it starts to shake back and forth.

The bearded man jumps with fright.
The young woman jumps with fright.

>look
Master Bedroom
You can see a teddy bear, a bedroom door, the king-sized bed (under the covers of which are a scared bearded man and a scared young woman), a TV, an alarm clock and a large window here.

>haunt door
The bedroom door starts to rattle.

>haunt door
The bedroom door starts to rattle.

>haunt window
You can't haunt the large window.

>haunt tv
You can't haunt the TV.

>restart
Are you sure you want to restart?

* * *

>y
Scaring 101
An Interactive Fiction by Mikrokosmonaut
Release 1 / Serial number 181202 / Inform 7 build 6M62 (I6/v6.33 lib 6/12N) SD

Landing
You can see a wooden door here.

>s
You shimmer through to the Hallway.

Hallway
You can see a bedroom door, a mirror and a radio here.

>in
You shimmer through to the Master Bedroom.

Master Bedroom
You can see a bedroom door, the king-sized bed (under the covers of which are a sleeping bearded man and a sleeping young woman), a TV, an alarm clock and a large window here.

>haunt door
The bedroom door starts to rattle.

The bearded man and the young woman wake up wondering what is going on. 

Someone has woken up.

The teddy bear arrives from the outside.

>haunt door
The bedroom door starts to rattle.

>look
Master Bedroom
You can see a teddy bear, a bedroom door, the king-sized bed (under the covers of which are a scared bearded man and a scared young woman), a TV, an alarm clock and a large window here.

* * *

>z
Time passes.

>out
You shimmer through to the Hallway.

Hallway
You can see a bedroom door, a teddy bear, a mirror and a radio here.

* * *

>haunt door
The bedroom door starts to rattle.

The bearded man and the young woman wake up wondering what is going on. 

[Your score has just gone up by two points.]

>haunt door
The bedroom door starts to rattle.

The bearded man and the young woman look a little shaken. 

[Your score has just gone up by two points.]

>haunt door
The bedroom door starts to rattle.

* * *

>haunt door
The bedroom door starts to rattle.

The bearded man and the young woman look a little shaken. 

[Your score has just gone up by two points.]

>haunt bed
As you haunt the king-sized bed, it starts to shake back and forth.

The bearded man and the young woman scream.

[Your score has just gone up by two points.]

>haunt alarm
The alarm clock suddenly starts ringing.

The bearded man and the young woman jump with fright.

The young woman switches the alarm clock off.

[Your score has just gone up by three points.]

>out
You shimmer through to the Hallway.

Hallway
You can see a bedroom door, a teddy bear, a mirror and a radio here.

* * *

>haunt lamp
The bulb of the lamp flickers on and off for a few seconds.

The young boy looks unsettled enough as it is. 

The young boy switches the lamp off.

>haunt bed
As you haunt the child's bed, it starts to shake back and forth.

The young boy screams.

    *** Done! ***

In that game you scored 11 out of a possible 9, in 11 turns.

Would you like to RESTART, RESTORE a saved game, QUIT or UNDO the last command?

>restart
Scaring 101
An Interactive Fiction by Mikrokosmonaut
Release 1 / Serial number 181202 / Inform 7 build 6M62 (I6/v6.33 lib 6/12N) SD

Hallway
You can see a bedroom door, a mirror and a radio here.

>in
You shimmer through to the Master Bedroom.

Master Bedroom
You can see a bedroom door, the king-sized bed (under the covers of which are a sleeping bearded man and a sleeping young woman), a TV, an alarm clock and a large window here.

>haunt door
The bedroom door starts to rattle.

The bearded man and the young woman wake up wondering what is going on. 

[Your score has just gone up by two points.]

>look
Master Bedroom
You can see a bedroom door, the king-sized bed (under the covers of which are a confused bearded man and a confused young woman), a TV, an alarm clock and a large window here.

>haunt door
The bedroom door starts to rattle.

The bearded man and the young woman look a little shaken. 

[Your score has just gone up by two points.]

>look
Master Bedroom
You can see a bedroom door, the king-sized bed (under the covers of which are an unsettled bearded man and an unsettled young woman), a TV, an alarm clock and a large window here.

>haunt alarm
The alarm clock suddenly starts ringing.

The bearded man and the young woman jump with fright.

The young woman switches the alarm clock off.

[Your score has just gone up by three points.]

>haunt alarm
The alarm clock suddenly starts ringing.

The bearded man and the young woman jump with fright.

The bearded man switches the alarm clock off.

[Your score has just gone up by two points.]

>haunt alarm
The alarm clock suddenly starts ringing.

The bearded man and the young woman jump with fright.

The young woman switches the alarm clock off.

[Your score has just gone up by two points.]

* * *

>in
You shimmer through to the Child's Bedroom.

Child's Bedroom
A typical kid's bedroom - all bright colours and optimism. You'd spit if you could. A small window paints a trapeziod of light over the young boy. There is a wooden door leading out.

You can see the child's bed (under the covers of which is a sleeping young boy), a teddy bear with a bored look on his face, a lamp and a closet here.

"Psst! It's me" hisses your plush companion.

>haunt alarm
The bearded man and the young woman wake up with a start.

>x alarm
The alarm clock is currently switched on.

The teddy bear arrives from the outside.

* * *

>in
You shimmer through to the Child's Bedroom.

Child's Bedroom
A typical kid's bedroom - all bright colours and optimism. You'd spit if you could. A small window paints a trapeziod of light over the young boy. There is a wooden door leading out.

You can see the child's bed (under the covers of which is a sleeping young boy), a teddy bear with a bored look on his face, a lamp and a closet here.

"Psst! It's me" hisses your plush companion.

>haunt tv
The TV switches itself on and begins to cycle through channels seemingly at random.

The bearded man switches the TV off.

>haunt door
The bearded man and the young woman wake up wondering what is going on. 

The bedroom door starts to rattle.

The teddy bear arrives from the outside.

* * *

>in
You shimmer through to the Child's Bedroom.

Child's Bedroom
A typical kid's bedroom - all bright colours and optimism. You'd spit if you could. A small window paints a trapeziod of light over the young boy. There is a wooden door leading out.

You can see the child's bed (under the covers of which is a sleeping young boy), a teddy bear with a bored look on his face, a lamp and a closet here.

"Psst! It's me" hisses your plush companion.

>out
You shimmer through to the Hallway.

Hallway
A mirror hangs on the wall here. A bedroom door leads back in to the master bedroom. The landing lies to the north.

You can see a pedestal (on which is a radio) here.

The teddy bear waddles in from the Landing.

>in
You shimmer through to the Master Bedroom.

Master Bedroom
You can see a bedroom door, the king-sized bed (under the covers of which are a sleeping bearded man and a sleeping young woman), a TV and a bed-side table (on which is an alarm clock) here.

The teddy bear waddles in from the Hallway. The teddy bear whispers "Keep in mind rule #3: variety is vital to a good haunt".

>haunt door
The wooden door slams shut.

The young boy wakes up wondering what is going on. 

[Your score has just gone up by one point.]

>look
Child's Bedroom
You can see a teddy bear, a wooden door, the child's bed (under the covers of which is a confused young boy), a lamp and a closet (empty) here.

* * *

>in
You shimmer through to the Child's Bedroom.

Child's Bedroom
A typical kid's bedroom - all bright colours and optimism. You'd spit if you could. A small window paints a trapeziod of light over the young boy. There is a wooden door leading out.

You can see the child's bed (under the covers of which is a sleeping young boy), a teddy bear with a bored look on his face, a lamp and a closet here.

"Psst! It's me" hisses your plush companion.

>z
Time passes.

>z
Time passes.

The teddy bear waddles in from the Hallway.

>haunt door
The bedroom door slams shut.

The bearded man and the young woman wake up with a start. 

The teddy bear falls to the floor to avoid being noticed.

[Your score has just gone up by three points.]

>look
Master Bedroom
You can see a teddy bear, a bedroom door, the king-sized bed (under the covers of which are an unsettled bearded man and an unsettled young woman), a TV, an alarm clock and a large window here.

>x window
You see nothing special about the large window.

* * *

>haunt door
The bedroom door slams shut.

The bearded man and the young woman wake up with a start. 

The teddy bear falls to the floor to avoid being noticed.

[Your score has just gone up by three points.]

>haunt alarm
The alarm clock suddenly starts ringing.

The bearded man and the young woman jump with fright.

The teddy bear falls to the floor.

The young woman switches the alarm clock off.

[Your score has just gone up by two points.]

* * *

>z
Time passes.

The teddy bear waddles in from the Hallway.

>z
Time passes.

>z
Time passes.

The teddy bear whispers "Keep in mind rule #1: always consider your surroundings".

>haunt window
The large window starts to rattle.

The bearded man and the young woman wake up wondering what is going on. The teddy bear immediately falls to the floor to avoid being noticed. 

[Your score has just gone up by two points.]

* * *

>z
Time passes.

>out
You shimmer through to the Hallway.

Hallway
You can see a bedroom door, a mirror and a pedestal (on which is a radio) here.

The teddy bear quietly crawls out from the Master Bedroom.

The teddy bear gets to his feet.

* * *

>z
Time passes.

The teddy bear waddles in from the Hallway.

>haunt window
The large window starts to rattle.

The bearded man and the young woman wake up wondering what is going on. The teddy bear immediately falls to the floor to avoid being noticed. 

[Your score has just gone up by two points.]

* * *

>z
Time passes.

>out
You shimmer through to the Hallway.

Hallway
You can see a bedroom door, a mirror and a pedestal (on which is a radio) here.

The teddy bear quietly crawls out from the Master Bedroom. The teddy bear gets to his feet. 

The teddy bear whispers "Keep in mind rule #1: always consider your surroundings".

* * *

>in
You shimmer through to the Child's Bedroom.

Child's Bedroom
A typical kid's bedroom - all bright colours and optimism. You'd spit if you could. A small window paints a trapeziod of light over the young boy. There is a wooden door leading out.

You can see the child's bed (under the covers of which is a sleeping young boy), a teddy bear with a bored look on his face, a lamp and a closet here.

"Psst! It's me" hisses your plush companion.

>haunt closet
The closet slowly opens revealing some clothes and a jack-in-box.

The young boy wakes up wondering what is going on. The teddy bear immediately falls to the floor to avoid being noticed. 

[Your score has just gone up by one point.]

* * *

>haunt clothes
The clothes fly out of the closet in all directions.

The young boy screams. 

[Your score has just gone up by one point.]

>look
Child's Bedroom
You can see some clothes, a wooden door, the child's bed (under the covers of which is a scared young boy), a teddy bear, a lamp and a closet (in which is a jack-in-box) here.

* * *

>in
You shimmer through to the Child's Bedroom.

Child's Bedroom
A typical kid's bedroom - all bright colours and optimism. You'd spit if you could. A small window paints a trapeziod of light over the young boy. There is a wooden door leading out.

You can see the child's bed (under the covers of which is a sleeping young boy), a teddy bear with a bored look on his face, a lamp and a closet here.

"Psst! It's me" hisses your plush companion.

>haunt table
The bed-side table starts to shake aggressively causing the alarm clock to rattle.

The bearded man and the young woman wake up wondering what is going on. 

[Your score has just gone up by two points.]

>haunt table
The bed-side table starts to shake aggressively causing the alarm clock to rattle.

The bearded man and the young woman look a little shaken. 

[Your score has just gone up by two points.]

>haunt alarm
The alarm clock suddenly starts ringing.

The bearded man and the young woman jump with fright. The young woman switches the alarm clock off.

[Your score has just gone up by three points.]

* * *

>haunt table
The bed-side table starts to shake aggressively causing the alarm clock to rattle.

The bearded man and the young woman look unsettled enough as it is. The alarm clock falls to the floor.

>haunt table
The bed-side table starts to shake aggressively.

The bearded man and the young woman look unsettled enough as it is.

>haunt table
The bed-side table starts to shake aggressively.

The bearded man and the young woman look unsettled enough as it is.

>haunt alarm
The alarm clock suddenly starts ringing.

The bearded man and the young woman jump with fright. The bearded man switches the alarm clock off.

[Your score has just gone up by three points.]

>out
You're a poltergeist. You're not in the business of exiting.

* * *

>in
You shimmer through to the Child's Bedroom.

Child's Bedroom
A typical kid's bedroom - all bright colours and optimism. You'd spit if you could. A small window paints a trapeziod of light over the young boy. There is a wooden door leading out.

You can see the child's bed (under the covers of which is a sleeping young boy), a teddy bear with a bored look on his face, a lamp and a closet here.

"Psst! It's me" hisses your plush companion.

>haunt bed
As you haunt the child's bed, it starts to shake back and forth.

The young boy wakes up not quite sure of what's going on. The teddy bear immediately drops to the floor to evade suspicion. 

[Your score has just gone up by one point.]

>haunt bed
As you haunt the child's bed, it starts to shake back and forth.

The young boy screams. The young boy leaps out of nothing.

The young boy runs off into the Landing, looking fairly scared.

[Your score has just gone up by one point.]

>l
Child's Bedroom
A typical kid's bedroom - all bright colours and optimism. You'd spit if you could. A small window paints a trapeziod of light over the young boy. There is a wooden door leading out.

You can see the child's bed (under the covers of which is a scared young boy), a teddy bear, a lamp and a closet here.

>look
Child's Bedroom
A typical kid's bedroom - all bright colours and optimism. You'd spit if you could. A small window paints a trapeziod of light over the young boy. There is a wooden door leading out.

You can see the child's bed (under the covers of which is a scared young boy), a teddy bear, a lamp and a closet here.

>showme boy
young boy - victim
location: in the child's bed in the Child's Bedroom
singular-named, improper-named; unlit, inedible, portable, unhauntable; male, passive
list grouping key: none
printed name: "young boy"
printed plural name: "victims"
indefinite article: none
description: "The young boy looks quite scared."
initial appearance: none
weirdness: none
carrying capacity: 100
quarters: king-sized bed
fear-state: scared

>scenes
Scene 'Entire Game' playing (for 5 mins now)
Scene 'Sound Asleep' ended
Scene 'Paranormal Activity' playing (for 4 mins now)
Scene 'Run to Mommy' playing (for 3 mins now)
(Scene monitoring now switched on. Type "scenes off" to switch it off again.)

* * *

>l
Child's Bedroom
A typical kid's bedroom - all bright colours and optimism. You'd spit if you could. A small window paints a trapeziod of light over the young boy. There is a wooden door leading out.

You can see the child's bed (under the covers of which is a scared young boy), a teddy bear, a lamp and a closet here.

>l
Child's Bedroom
A typical kid's bedroom - all bright colours and optimism. You'd spit if you could. A small window paints a trapeziod of light over the young boy. There is a wooden door leading out.

You can see the child's bed (under the covers of which is a scared young boy), a teddy bear, a lamp and a closet here.

>showme boy
young boy - victim
location: in the child's bed in the Child's Bedroom
singular-named, improper-named; unlit, inedible, portable, unhauntable; male, active
list grouping key: none
printed name: "young boy"
printed plural name: "victims"
indefinite article: none
description: "The young boy looks pretty scared."
initial appearance: none
weirdness: none
carrying capacity: 100
quarters: king-sized bed
fear-state: scared

* * *

>in
You shimmer through to the Master Bedroom.

Master Bedroom
Moonlight shines in through the large window, the shadow of the frame artificially segmenting the man and woman as if silently commenting on the state of their marriage.  A bedroom door leads back out to the hallway. 

You can see a young boy, the king-sized bed (under the covers of which are a sleeping bearded man and a sleeping young woman), a TV and a bed-side table (on which are an alarm clock and a flashlight) here.

The young boy gets into the king-sized bed and pulls the covers over himself with a scared look on his face.

>look
Master Bedroom
Moonlight shines in through the large window, the shadow of the frame artificially segmenting the man and woman as if silently commenting on the state of their marriage.  A bedroom door leads back out to the hallway. 

You can see the king-sized bed (under the covers of which are a scared young boy, a sleeping bearded man and a sleeping young woman), a TV and a bed-side table (on which are an alarm clock and a flashlight) here.

* * *

>in
You shimmer through to the Master Bedroom.

Master Bedroom
Moonlight shines in through the large window, the shadow of the frame artificially segmenting the man and woman as if silently commenting on the state of their marriage.  A bedroom door leads back out to the hallway. 

You can see a young boy, the king-sized bed (under the covers of which are a sleeping bearded man and a sleeping young woman), a TV and a bed-side table (on which are an alarm clock and a flashlight) here.

The young boy gets into the king-sized bed and pulls the covers over himself with a scared look on his face.

>haunt bed
As you haunt the king-sized bed, it starts to shake back and forth.

The bearded man and the young woman wake up not quite sure of what's going on. The young boy screams. 

[Your score has just gone up by two points.]

>haunt bed
As you haunt the king-sized bed, it starts to shake back and forth.

The young boy, the bearded man and the young woman scream. 

    *** After scaring the poor family half to death, you decide to return to the ether before you do any serious damage.

What a night! Maybe this being dead thing business isn't as dull as you"d initially suspected. As you shimmer outside preparing to leave, the teddy bear catches you up. "Personally, I'd give you C" he comments, only half-jokingly. "That was good fun! I like how you work, but there are a few things I can show you. You just need to take your time with it" he suggests. Good work! ***

In that game you scored 6 out of a possible 10, in 8 turns.

Would you like to RESTART, RESTORE a saved game, QUIT or UNDO the last command?

>restart
Thursday night. Thursday, a concept that means very little to the recently deceased, which you most certainly are; and night, which as it turns out, is quickly becoming your favourite part of whole night-day dichotomy.

Haunting is on the cards for this particular evening. The supernatural, as it happens, is perfectly natural - common even. You've chosen a typical suburban house inhabited by a small family for the occasion. Your aim - confuse them, creep them out and scare them silly!

You're still new to this whole possession malarky, but an undead buddy of yours has kindly agreed to come along to offer pointers here and there. He said he'd meet you there.

Hint: To possess an item, try '>haunt the window' or '>haunt the lamp'.

Landing
A framed family photo hangs on the wall. "The illusion of permanence" you think to yourself. A wooden door leads in to the child's bedroom. The hallway itself continues south from here and while there is a staircase leading down to the first floor, all the fun (read horror) is up here.

You can see a ball here.

Scaring 101
An Interactive Fiction by Mikrokosmonaut
Release 1 / Serial number 181205 / Inform 7 build 6M62 (I6/v6.33 lib 6/12N) SD

Landing
A framed family photo hangs on the wall. A wooden door leads in to the child's bedroom. The hallway itself continues south from here and while there is a staircase leading down to the first floor, all the fun is up here.

You can see a ball here.

>in
You shimmer through to the Child's Bedroom.

Child's Bedroom
A typical kid's bedroom - all bright colours and optimism. You'd spit if you could. A small window paints a trapeziod of light over the young boy. There is a wooden door leading out.

You can see the child's bed (under the covers of which is a sleeping young boy), a teddy bear with a bored look on his face, a lamp and a closet here.

"Psst! It's me" hisses your plush companion.

The teddy bear whispers "Don't forget rule #1: always consider your surroundings".

>haunt lamp
The lamp flickers on and off randomly for a few seconds.

The young boy wakes up wondering what is going on. The teddy bear immediately collapses to the floor to avoid being noticed. With a confused look on his face, the young boy switches the lamp off.

[Your score has just gone up by one point.]

>haunt bed
As you haunt the child's bed, it starts to shake back and forth.

The young boy screams. The young boy leaps out of nothing.

The young boy runs off into the Landing, looking fairly scared.

[Your score has just gone up by one point.]

* * *

>in
You shimmer through to the Child's Bedroom.

Child's Bedroom
A typical kid's bedroom - all bright colours and optimism. You'd spit if you could. A small window paints a trapeziod of light over the young boy. There is a wooden door leading out.

You can see the child's bed (under the covers of which is a sleeping young boy), a teddy bear with a bored look on his face, a lamp and a closet here.

"Psst! It's me" hisses your plush companion.

>look
Child's Bedroom
A typical kid's bedroom - all bright colours and optimism. You'd spit if you could. A small window paints a trapeziod of light over the young boy. There is a wooden door leading out.

You can see the child's bed (under the covers of which is a sleeping young boy), a teddy bear, a lamp and a closet here.

* * *

>restart
Are you sure you want to restart?

* * *

>y
Scaring 101
An Interactive Fiction by Mikrokosmonaut
Release 1 / Serial number 181203 / Inform 7 build 6M62 (I6/v6.33 lib 6/12N) SD

Master Bedroom
You can see a bedroom door, the king-sized bed (under the covers of which are a sleeping bearded man and a sleeping young woman), a TV and an alarm clock here.

>haunt door
The bedroom door starts to rattle.

The bearded man and the young woman wake up wondering what is going on.

Someone has woken up.

>out
You shimmer through to the Hallway.

Hallway
You can see a bedroom door, a mirror and a radio here.

The teddy bear arrives from the north.

* * *

>in
You shimmer through to the Child's Bedroom.

Child's Bedroom
You can see a wooden door, the child's bed (under the covers of which is a sleeping young boy), a lamp and a closet (empty) here.

The teddy bear arrives from the outside.

>haunt door
The wooden door starts to rattle.

>look
Child's Bedroom
You can see a teddy bear, a wooden door, the child's bed (under the covers of which is a scared young boy), a lamp and a closet (empty) here.

>restart
Are you sure you want to restart?

>y
Scaring 101
An Interactive Fiction by Mikrokosmonaut
Release 1 / Serial number 181202 / Inform 7 build 6M62 (I6/v6.33 lib 6/12N) SD

Hallway
You can see a bedroom door, a mirror and a radio here.

>s
You can't go that way.

>n
You shimmer through to the Landing.

Landing
You can see a wooden door and a teddy bear here.

* * *

>in
You shimmer through to the Child's Bedroom.

Child's Bedroom
You can see a wooden door, the child's bed (under the covers of which is a sleeping young boy), a lamp and a closet (empty) here.

The teddy bear arrives from the outside.

>haunt lamp
The bulb of the lamp flickers on and off for a few seconds.

The young boy wakes up wondering what is going on.

Someone has woken up.

* * *

>y
Scaring 101
An Interactive Fiction by Mikrokosmonaut
Release 1 / Serial number 181203 / Inform 7 build 6M62 (I6/v6.33 lib 6/12N) SD

Master Bedroom
You can see a bedroom door, the king-sized bed (under the covers of which are a sleeping bearded man and a sleeping young woman), a TV and an alarm clock here.

>look
Hallway
You can see a bedroom door, a mirror and a radio here.

>in
You shimmer through to the Master Bedroom.

Master Bedroom
You can see a bedroom door, the king-sized bed (under the covers of which are a sleeping bearded man and a sleeping young woman), a TV and an alarm clock here.

>out
You shimmer through to the Hallway.

Hallway
You can see a bedroom door, a teddy bear, a mirror and a radio here.

* * *

>y
Scaring 101
An Interactive Fiction by Mikrokosmonaut
Release 1 / Serial number 181203 / Inform 7 build 6M62 (I6/v6.33 lib 6/12N) SD

Hallway
You can see a bedroom door, a mirror and a radio here.

>restart
Are you sure you want to restart?

* * *

>haunt radio
The radio switches itself on and begins to cycle through channels seemingly at random.

The teddy bear arrives from the north.

[Your score has just gone up by three points.]

>restart
Are you sure you want to restart?

* * *

>y
Scaring 101
An Interactive Fiction by Mikrokosmonaut
Release 1 / Serial number 181203 / Inform 7 build 6M62 (I6/v6.33 lib 6/12N) SD

Landing
You can see a wooden door here.

>restart
Are you sure you want to restart?

* * *

>haunt radio
The radio switches itself on and begins to cycle through channels seemingly at random.

[Your score has just gone up by three points.]

>z
Time passes.

The teddy bear arrives from the north.

>z
Time passes.

The young boy arrives from the north.

>z
Time passes.

The young boy switches the radio off.

The young boy goes north.

>z
Time passes.

* * *

>haunt tv
The TV switches itself on and begins to cycle through channels seemingly at random.

>haunt door
The bedroom door starts to rattle.

The bearded man and the young woman wake up wondering what is going on. 

The young woman switches the TV off.

>look
Master Bedroom
You can see a bedroom door, the king-sized bed (under the covers of which are a confused bearded man and a confused young woman), a TV, an alarm clock and a large window here.

The teddy bear arrives from the outside.

>haunt alarm
The alarm clock suddenly starts ringing.

The bearded man and the young woman jump with fright.

The bearded man switches the alarm clock off.

>look
Master Bedroom
You can see a teddy bear, a bedroom door, the king-sized bed (under the covers of which are a scared bearded man and a scared young woman), a TV, an alarm clock and a large window here.

* * *

>in
You shimmer through to the Child's Bedroom.

Child's Bedroom
You can see a wooden door, the child's bed (under the covers of which is a confused young boy), a lamp and a closet (empty) here.

The teddy bear arrives from the outside.

>haunt bed
As you haunt the child's bed, it starts to shake back and forth.

The young boy screams.

    *** Done! ***

Would you like to RESTART, RESTORE a saved game, QUIT or UNDO the last command?

* * *

>haunt bear
You can't haunt the teddy bear.

>haunt lamp
The bulb of the lamp flickers on and off for a few seconds.

The young boy wakes up wondering what is going on. 

The teddy bear immediately falls to the floor to avoid being noticed. Looks like you're on your own now.

The young boy switches the lamp off.

[Your score has just gone up by one point.]

* * *

>look
Child's Bedroom
A typical kid's bedroom - all bright colours and optimism. You'd spit if you could. A small window paints a trapeziod of light over the young boy. There is a wooden door leading out.

You can see the child's bed (under the covers of which is a sleeping young boy), a teddy bear with a bored look on his face, a lamp and a closet here.

"Psst! It's me" hisses your plush companion.

>out
You shimmer through to the Landing.

Landing
A framed family photo hangs on the wall. "The illusion of permanence" you think to yourself. A wooden door leads back in to the child's bedroom. The hallway itself continues south from here and while there is a staircase leading down to the first floor, all the fun (read horror) is up here.

You can see a ball here.

The teddy bear with a bored look on its face waddles in from the Child's Bedroom.

>s
You can't go that way.

>in
You shimmer through to the Master Bedroom.

Master Bedroom
You can see a bedroom door, the king-sized bed (under the covers of which are a sleeping bearded man and a sleeping young woman), a TV and an alarm clock here.

The teddy bear arrives from the outside.

>out
You shimmer through to the Hallway.

Hallway
You can see a bedroom door, a mirror and a radio here.

The teddy bear arrives from the inside.

>n
You shimmer through to the Landing.

Landing
You can see a wooden door and a ball here.

The teddy bear arrives from the south.

>s
You shimmer through to the Hallway.

Hallway
You can see a bedroom door, a mirror and a radio here.

The teddy bear arrives from the north.

>n
You shimmer through to the Landing.

Landing
You can see a wooden door and a ball here.

The teddy bear arrives from the south.

>in
You shimmer through to the Child's Bedroom.

Child's Bedroom
You can see a wooden door, the child's bed (under the covers of which is a sleeping young boy), a lamp and a closet (empty) here.

The teddy bear arrives from the outside.

>haunt closet
The closet closes with a slam.

The young boy wakes up with a start. The teddy bear immediately falls to the floor to avoid being noticed. 

[Your score has just gone up by three points.]

* * *

>look
Child's Bedroom
A typical kid's bedroom - all bright colours and optimism. You'd spit if you could. A small window paints a trapeziod of light over the young boy. There is a wooden door leading out.

You can see the child's bed (under the covers of which is a sleeping young boy), a teddy bear with a bored look on his face, a lamp and a closet here.

"Psst! It's me" hisses your plush companion.

>z
Time passes.

The teddy bear arrives from the north.

The teddy bear whispers "Don't forget rule #3: variety is vital to a good haunt".

* * *

>haunt radio
The radio switches itself on and begins to cycle through channels seemingly at random.

[Your score has just gone up by three points.]

>z
Time passes.

The teddy bear waddles in from the Landing.

The teddy bear collapses to the floor in anticipation of someone coming. The young woman arrives from the Master Bedroom, looking quite confused.

>z
Time passes.

With a confused look on her face, the young woman switches the radio off.

The young woman goes to the Master Bedroom, looking fairly confused.

>z
Time passes.

The teddy bear gets to his feet.

* * *

>z
Time passes.

>look
Hallway
You can see a bedroom door, a teddy bear, a mirror and a radio here.

>x teddy
You see nothing special about the teddy bear.

>haunt radio
The radio switches itself on and begins to cycle through channels seemingly at random.

>z
Time passes.

The bearded man arrives from the inside.

>haunt radio
The radio switches itself on and begins to cycle through channels seemingly at random.

The bearded man jumps with fright. The bearded man switches the radio off.

The bearded man goes inside.

[Your score has just gone up by one point.]

>z
Time passes.

>haunt radio
The radio switches itself on and begins to cycle through channels seemingly at random.

The teddy bear whispers "Keep in mind rule #1: always consider your surroundings".

>z
Time passes.

The teddy bear collapses to the floor in anticipation of someone coming. The young woman arrives from the Master Bedroom, looking quite confused.

>z
Time passes.

With a confused look on her face, the young woman switches the radio off.

The young woman goes to the Master Bedroom, looking fairly confused.

* * *

>haunt radio
The radio switches itself on and begins to cycle through channels seemingly at random.

>z
Time passes.

The teddy bear collapses to the floor in anticipation of someone coming. The bearded man arrives from the Master Bedroom, looking quite confused.

>in
You shimmer through to the Master Bedroom.

Master Bedroom
You can see a bedroom door, the king-sized bed (under the covers of which is a confused young woman), a TV and a bed-side table (on which is an alarm clock) here.

The bearded man arrives from the Hallway, looking quite confused.

>z
Time passes.

The bearded man gets back into the king-sized bed and pulls the covers over himself with a confused look on his face.

>z
Time passes.

>l
Master Bedroom
You can see a bedroom door, the king-sized bed (under the covers of which are a confused bearded man and a confused young woman), a TV and a bed-side table (on which is an alarm clock) here.

>x door
The wooden door is open.

>out
You shimmer through to the Hallway.

Hallway
You can see a bedroom door, a teddy bear, a mirror and a pedestal (on which is a radio) here.

>s
You can't go that way.

>n
You shimmer through to the Landing.

Landing
You can see a wooden door and a ball here.

The teddy bear waddles in from the Hallway.

>haunt ball
The ball spontaneously rolls off towards the Hallway.

>n
You can't go that way.

The teddy bear whispers "Don't forget rule #3: variety is vital to a good haunt".

>s
You shimmer through to the Hallway.

Hallway
You can see a ball, a bedroom door, a mirror and a pedestal (on which is a radio) here.

The teddy bear waddles in from the Landing.

The teddy bear whispers "It's worth giving a little thought to rule #2: make sure to take your time".

>haunt radio
The radio switches itself on and begins to cycle through channels seemingly at random.

* * *

>z
Time passes.

The teddy bear collapses to the floor in anticipation of someone coming. The bearded man arrives from the Master Bedroom, looking quite confused.

>haunt ball
The ball spontaneously rolls off towards the Landing.

The bearded man looks a little shaken. With an unsettled look on his face, the bearded man switches the radio off.

The bearded man goes to the Master Bedroom, looking fairly unsettled.

[Your score has just gone up by one point.]

>in
You shimmer through to the Master Bedroom.

Master Bedroom
You can see a bedroom door, a bearded man, the king-sized bed (under the covers of which is a confused young woman), a TV and a bed-side table (on which is an alarm clock) here.

The bearded man gets back into the king-sized bed and pulls the covers over himself with an unsettled look on his face.

>out
You shimmer through to the Hallway.

Hallway
You can see a bedroom door, a teddy bear, a mirror and a pedestal (on which is a radio) here.

The teddy bear whispers "It's worth giving a little thought to rule #1: always consider your surroundings".

>haunt
What do you want to haunt?

>haunt radio
The radio switches itself on and begins to cycle through channels seemingly at random.

>z
Time passes.

The teddy bear collapses to the floor in anticipation of someone coming. The bearded man arrives from the Master Bedroom, looking quite unsettled.

>z
Time passes.

With an unsettled look on his face, the bearded man switches the radio off.

The bearded man goes to the Master Bedroom, looking fairly unsettled.

>haunt radio
The radio switches itself on and begins to cycle through channels seemingly at random.

The teddy bear collapses to the floor in anticipation of someone coming. The bearded man arrives from the Master Bedroom, looking quite unsettled.

>haunt radio
The radio gives off a loud whine of interference and the continues cycling through channels seemingly at random.

The bearded man jumps with fright. With a scared look on his face, the bearded man switches the radio off.

The bearded man goes to the Master Bedroom, looking fairly scared.

[Your score has just gone up by one point.]

>z
Time passes.

The teddy bear gets to his feet.

* * *

>z
Time passes.

>z
Time passes.

The teddy bear whispers "Don't forget rule #3: variety is vital to a good haunt".

>z
Time passes.

>z
Time passes.

The teddy bear whispers "Keep in mind rule #2: make sure to take your time".

>z
Time passes.

>z
Time passes.

The teddy bear whispers "Don't forget rule #1: always consider your surroundings".

>z
Time passes.

* * *

>z
Time passes.

With a confused look on her face, the young woman switches the radio off.

The young woman goes to the Master Bedroom, looking fairly confused.

>n
You shimmer through to the Landing.

Landing
You can see a wooden door and a ball here.

The teddy bear waddles in from the Hallway.

The teddy bear gets to his feet. The young boy arrives from the Hallway, looking quite confused.

>in
You shimmer through to the Child's Bedroom.

Child's Bedroom
You can see a wooden door, the child's bed, a lamp and a closet here.

The teddy bear waddles in from the Landing.

The teddy bear gets to his feet. The young boy arrives from the Landing, looking quite confused.

>z
Time passes.

The teddy bear immediately falls to the floor to avoid being noticed. The young boy gets back into the child's bed and pulls the covers over himself with a confused look on his face.

* * *

>z
Time passes.

The teddy bear waddles in from the Landing.

The teddy bear collapses to the floor in anticipation of someone coming. The young woman arrives from the Master Bedroom, looking quite confused.

>in
You shimmer through to the Master Bedroom.

Master Bedroom
You can see a bedroom door, the king-sized bed (under the covers of which is a confused young woman), a TV and a bed-side table (on which is an alarm clock) here.

The bearded man arrives from the Master Bedroom, looking quite confused.

>z
Time passes.

The bearded man gets back into the king-sized bed and pulls the covers over himself with a confused look on his face.

* * *

>haunt radio
The radio switches itself on and begins to cycle through channels seemingly at random.

[Your score has just gone up by three points.]

>n
You shimmer through to the Landing.

Landing
You can see a wooden door and a teddy bear here.

The young boy arrives from the inside.

>in
You shimmer through to the Child's Bedroom.

Child's Bedroom
You can see a wooden door, the child's bed, a lamp and a closet (empty) here.

The teddy bear arrives from the outside.

>z
Time passes.

Someone can see the radio.

>z
Time passes.

The young boy arrives from the outside.

>z
Time passes.

The young boy can see child's bed

>z
Time passes.

The young boy can see child's bed

>rules on
Rules tracing now switched on. Type "rules off" to switch it off again, or "rules all" to include even rules which do not apply.

* * *

>rules off
[Rule "declare everything initially unmentioned rule" applies.]
Rules tracing now switched off. Type "rules" to switch it on again.

>actions on
Actions listing on.

>look
[looking]
Child's Bedroom
You can see a young boy, a teddy bear, a wooden door, the child's bed, a lamp and a closet (empty) here.

[looking - succeeded]

The young boy can see child's bed
[the young boy entering the child's bed]
[the young boy entering the child's bed - failed the can't enter what's not enterable rule]

* * *

>haunt radio
The radio switches itself on and begins to cycle through channels seemingly at random.

[Your score has just gone up by three points.]

>s
You can't go that way.

The teddy bear arrives from the north.

>n
You shimmer through to the Landing.

Landing
You can see a wooden door and a young boy here.

The young boy goes south.

>in
You shimmer through to the Child's Bedroom.

Child's Bedroom
You can see a wooden door, the child's bed, a lamp and a closet (empty) here.

Someone can see the radio.

>z
Time passes.

The teddy bear arrives from the outside.

The young boy arrives from the outside.

>z
Time passes.

The young boy can see child's bed
The young boy gets into the child's bed.

* * *

>haunt radio
The radio switches itself on and begins to cycle through channels seemingly at random.

[Your score has just gone up by three points.]

>in
You shimmer through to the Master Bedroom.

Master Bedroom
You can see a bedroom door, a bearded man, the king-sized bed (under the covers of which is a confused young woman), a TV and a bed-side table (on which is an alarm clock) here.

The teddy bear collapses to the floor in anticipation of someone coming.

* * *

>show me teddy
(first taking the teddy bear)
You're a poltergeist. You're not in the business of taking.

>showme teddy
teddy bear - toy
location: in the Child's Bedroom
singular-named, improper-named; unlit, inedible, portable, unhauntable; male, active
list grouping key: none
printed name: "teddy bear"
printed plural name: "toys"
indefinite article: none
description: none
initial appearance: none
weirdness: none
carrying capacity: 100

>out
You shimmer through to the Landing.

Landing
You can see a wooden door here.

The teddy bear arrives from the inside.

The teddy bear gets to his feet.

>showme teddy
teddy bear - toy
location: in the Landing
singular-named, improper-named; unlit, inedible, portable, unhauntable; male, active
list grouping key: none
printed name: "teddy bear"
printed plural name: "toys"
indefinite article: none
description: none
initial appearance: none
weirdness: none
carrying capacity: 100

* * *

>x closet
You see nothing special about the closet.

>haunt closet
The closet slowly opens revealing nothing.

The young boy wakes up wondering what is going on. The teddy bear immediately falls to the floor to avoid being noticed. 

[Your score has just gone up by one point.]

>haunt closet
The closet closes with a slam.

The young boy jumps with fright. 

[Your score has just gone up by three points.]

>look
Child's Bedroom
You can see a wooden door, the child's bed (under the covers of which is a scared young boy), a teddy bear, a lamp and a closet (closed) here.

* * *

>haunt table
You can't haunt the bed-side table.

>haunt alarm clock
The alarm clock suddenly starts ringing.

The bearded man and the young woman wake up with a start. The young woman switches the alarm clock off.

[Your score has just gone up by three points.]

* * *

>x door
The wooden door is closed.

The teddy bear waddles in from the The Child's Bedroom.

>haunt radio
The radio switches itself on and begins to cycle through channels seemingly at random.

The teddy bear arrives from the north.

[Your score has just gone up by three points.]

>z
Time passes.

The teddy bear whispers "It's worth giving a little thought to rule #2: make sure to take your time".

>z
Time passes.

The teddy bear collapses to the floor in anticipation of someone coming. The young boy arrives from the north.

* * *

>z
Time passes.

>z
Time passes.

The teddy bear whispers "It's worth giving a little thought to rule #3: variety is vital to a good haunt".

>z
Time passes.

* * *

>z
Time passes.

The teddy bear whispers "It's worth giving a little thought to rule #1: always consider your surroundings".

>haunt pedestal
The pedestal starts to shake aggressively causing the radio to rattle.

* * *

>haunt pedestal
The pedestal starts to shake aggressively causing the radio to rattle.

>haunt pedestal
The pedestal starts to shake aggressively.

The teddy bear arrives from the north.

The teddy bear whispers "It's worth giving a little thought to rule #3: variety is vital to a good haunt".

* * *

>x bear
The finer details of human possessions are of little interest to you.

>x closet
The finer details of human possessions are of little interest to you.

The teddy bear whispers "Don't forget rule #1: always consider your surroundings".

>haunt bed
As you haunt the child's bed, it starts to shake back and forth.

The young boy wakes up with a start. The young boy screams. The teddy bear immediately falls to the floor to avoid being noticed. 

[Your score has just gone up by four points.]

>haunt bed
As you haunt the child's bed, it starts to shake back and forth.

The young boy jumps with fright. The young boy screams.

* * *

>haunt mirror
(Easter Egg) The mirror displays the Windows ME logo. Just the thought is enough to make even a poltergeist shiver.

[Your score has just gone up by four points.]

>haunt mirror
The mirror displays a rolling landscape of faces, each stretched out in its own kind of suffering.

The teddy bear waddles in from the The Landing.

>haunt mirror
The mirror displays a constantly changing picture of random faces, each face suffering in its own way.

>haunt mirror
The mirror displays a constantly changing picture of random faces, each face suffering in its own way.

The teddy bear whispers "Keep in mind rule #2: make sure to take your time".

>haunt radio
The radio switches itself on and begins to cycle through channels seemingly at random.

[Your score has just gone up by three points.]

* * *

>z
Time passes.

The teddy bear collapses to the floor in anticipation of someone coming. The bearded man arrives from the inside.

>haunt mirror
The mirror perverts the reflection of the bearded man into a hideous caricature.

The bearded man screams. The bearded man switches the radio off.

The bearded man goes inside.

[Your score has just gone up by one point.]

* * *

>i
You're a poltergeist. You're not in the business of taking inventory.

The teddy bear waddles in from the The Child's Bedroom.

* * *

>x self
There's nothing there. You're a poltergeist.

The teddy bear waddles in from the The Child's Bedroom.

* * *

>haunt clock
The alarm clock suddenly starts ringing.

The bearded man and the young woman wake up with a start. With an unsettled look on her face, the young woman switches the alarm clock off.

[Your score has just gone up by three points.]

>haunt bunk
You can't see any such thing.

>haunt bed
As you haunt the king-sized bed, it starts to shake back and forth.

The bearded man and the young woman scream. 

[Your score has just gone up by two points.]

>haunt woman
You can't haunt the young woman.

* * *

>in
You shimmer through to the The Master Bedroom.

The Master Bedroom
You can see a bedroom door, the king-sized bed (under the covers of which are a sleeping bearded man and a sleeping young woman), a TV and a bed-side table (on which is an alarm clock) here.

>out
You shimmer through to the The Hallway.

The Hallway
You can see a bedroom door, a mirror and a pedestal (on which is a radio) here.

The teddy bear waddles in from the The Landing.

>s
You can't go that way.

>n
You shimmer through to the The Landing.

The Landing
You can see a wooden door, a ball and a framed family photo here.

The teddy bear waddles in from the The Hallway.

>in
You shimmer through to the The Child's Bedroom.

The Child's Bedroom
You can see a wooden door, the child's bed (under the covers of which is a sleeping young boy), a lamp and a closet here.

The teddy bear waddles in from the The Landing.

* * *

>go to child's bedroom
You can't see any such thing.

>go to bedroom
You can't see any such thing.

* * *

>enter bedroom
(first opening the bedroom door)
You're a poltergeist. You're not in the business of opening.

* * *

>go to bedroom
Which do you mean, the Child's Bedroom or the Master Bedroom?

>go to child's bedroom
You shimmer through to the Child's Bedroom.

Child's Bedroom
A typical kid's bedroom - all bright colours and optimism. You'd spit if you could. A small window paints a trapeziod of light over the young boy. There is a wooden door leading out.

You can see the child's bed (under the covers of which is a sleeping young boy), a teddy bear, a lamp and a closet here.

* * *

>go through door
You're a poltergeist. You're not in the business of entering.

The teddy bear whispers "Don't forget rule #1: always consider your surroundings".

>go through bedroom door
You can't go that way.

>out
You shimmer through to the Hallway.

Hallway
A mirror hangs on the wall here. "How incredibly vain the living are" you ponder for a few moments. A bedroom door leads back in to the master bedroom. The landing lies to the north.

You can see a teddy bear and a pedestal (on which is a radio) here.

* * *

>go through door
You're a poltergeist. You're not in the business of entering.

The teddy bear whispers "Don't forget rule #1: always consider your surroundings".

>enter
You can't go that way.

The teddy bear whispers "Don't forget rule #2: make sure to take your time".

>exit
*** Run-time problem P47 (at paragraph 247 in the source text): Phrase applied to an incompatible kind of value.

You shimmer through to the Landing.

Landing
A framed family photo hangs on the wall. "The illusion of permanence" you think to yourself. A wooden door leads back in to the child's bedroom. The hallway itself continues south from here and while there is a staircase leading down to the first floor, all the fun (read horror) is up here.

You can see a ball here.

The teddy bear waddles in from the Child's Bedroom.

* * *

>exit
You shimmer through to the Hallway.

Hallway
A mirror hangs on the wall here. "How incredibly vain the living are" you ponder for a few moments. A bedroom door leads back in to the master bedroom. The landing lies to the north.

You can see a pedestal (on which is a radio) here.

>enter
You shimmer through to the Master Bedroom.

Master Bedroom
Moonlight shines in through the large window, the shadow of the frame artificially segmenting the man and woman as if silently commenting on the state of their marriage.  A bedroom door leads back out to the hallway. 

You can see the king-sized bed (under the covers of which are a sleeping bearded man and a sleeping young woman), a TV and a bed-side table (on which are an alarm clock and a flashlight) here.

* * *

>enter
You shimmer through to the Master Bedroom.

Master Bedroom
Moonlight shines in through the large window, the shadow of the frame artificially segmenting the man and woman as if silently commenting on the state of their marriage.

You can see a bedroom door, the king-sized bed (under the covers of which are a sleeping bearded man and a sleeping young woman), a TV and a bed-side table (on which are an alarm clock and a torch) here.

>exit
You shimmer through to the Hallway.

Hallway
A mirror hangs on the wall here. A bedroom door leads back in to the master bedroom. The landing lies to the north.

You can see a pedestal (on which is a radio) here.

The teddy bear waddles in from the Landing.

* * *

>x boy
The young boy is sleeping.

>haunt closet
The closet slowly opens revealing some clothes and a jack-in-box.

The young boy wakes up wondering what is going on. The teddy bear immediately collapses to the floor to avoid being noticed. 

[Your score has just gone up by one point.]

>x boy
The young boy looks pretty confused.

>x boy
The young boy looks quite confused.

>x boy
The young boy looks pretty confused.

>x boy
The young boy looks fairly confused.

>x boy
The young boy looks quite confused.

>out
You shimmer through to the Landing.

Landing
A framed family photo hangs on the wall. "The illusion of permanence" you think to yourself. A wooden door leads back in to the child's bedroom. The hallway itself continues south from here and while there is a staircase leading down to the first floor, all the fun (read horror) is up here.

You can see a ball here.

The teddy bear quietly crawls out from the Child's Bedroom. The teddy bear gets to his feet.

>s
You shimmer through to the Hallway.

Hallway
A mirror hangs on the wall here. "How incredibly vain the living are" you ponder for a few moments. A bedroom door leads in to the master bedroom. The landing lies to the north.

You can see a pedestal (on which is a radio) here.

The teddy bear waddles in from the Landing. The teddy bear whispers "Keep in mind rule #1: always consider your surroundings".

>haunt mirror
(Easter Egg) The mirror displays the Windows ME logo. Just the thought is enough to make even a poltergeist shiver.

[Your score has just gone up by two points.]

>restart
Are you sure you want to restart?

* * *

>out
You shimmer through to the Hallway.

Hallway
A mirror hangs on the wall here. "How incredibly vain the living are" you ponder for a few moments. A bedroom door leads back in to the master bedroom. The landing lies to the north.

You can see a pedestal (on which is a radio) here.

>haunt mirror
(Easter Egg) The mirror displays the Windows ME logo. Just the thought is enough to make even a poltergeist shiver.

The teddy bear waddles in from the Landing. 

[Your score has just gone up by two points.]

>restart
Are you sure you want to restart?

>y
Scaring 101
An Interactive Fiction by Mikrokosmonaut
Release 1 / Serial number 181205 / Inform 7 build 6M62 (I6/v6.33 lib 6/12N) SD

Landing
A framed family photo hangs on the wall. "The illusion of permanence" you think to yourself. A wooden door leads in to the child's bedroom. The hallway itself continues south from here and while there is a staircase leading down to the first floor, all the fun (read horror) is up here.

You can see a ball here.

>s
You shimmer through to the Hallway.

Hallway
A mirror hangs on the wall here. "How incredibly vain the living are" you ponder for a few moments. A bedroom door leads in to the master bedroom. The landing lies to the north.

You can see a pedestal (on which is a radio) here.

* * *

>restart
Are you sure you want to restart?

>y
Scaring 101
An Interactive Fiction by Mikrokosmonaut
Release 1 / Serial number 181205 / Inform 7 build 6M62 (I6/v6.33 lib 6/12N) SD

Hallway
A mirror hangs on the wall here. "How incredibly vain the living are" you ponder for a few moments. A bedroom door leads in to the master bedroom. The landing lies to the north.

You can see a pedestal (on which is a radio) here.

>haunt mirror
(Easter Egg) The mirror displays the Windows ME logo. Just the thought is enough to make even a poltergeist shiver.

[Your score has just gone up by two points.]

* * *

>go in
You shimmer through to the Child's Bedroom.

Child's Bedroom
A typical kid's bedroom - all bright colours and optimism. You'd spit if you could. A small window paints a trapeziod of light over the young boy. There is a wooden door leading out.

You can see the child's bed (under the covers of which is a sleeping young boy), a teddy bear with a bored look on his face, a lamp and a closet here.

"Psst! It's me" hisses your plush companion.

>go out
You shimmer through to the Landing.

Landing
A framed family photo hangs on the wall. A wooden door leads back in to the child's bedroom. The hallway itself continues south from here and while there is a staircase leading down to the first floor, all the fun is up here.

You can see a ball here.

The teddy bear waddles in from the Child's Bedroom. The teddy bear whispers "It's worth giving a little thought to rule #3: variety is vital to a good haunt".

>enter
You shimmer through to the Child's Bedroom.

Child's Bedroom
A typical kid's bedroom - all bright colours and optimism. You'd spit if you could. A small window paints a trapeziod of light over the young boy. There is a wooden door leading out.

You can see the child's bed (under the covers of which is a sleeping young boy), a lamp and a closet here.

The teddy bear waddles in from the Landing.

>exit
You shimmer through to the Landing.

Landing
A framed family photo hangs on the wall. A wooden door leads back in to the child's bedroom. The hallway itself continues south from here and while there is a staircase leading down to the first floor, all the fun is up here.

You can see a ball here.

The teddy bear waddles in from the Child's Bedroom. The teddy bear whispers "Keep in mind rule #1: always consider your surroundings".

>enter
You shimmer through to the Child's Bedroom.

Child's Bedroom
A typical kid's bedroom - all bright colours and optimism. You'd spit if you could. A small window paints a trapeziod of light over the young boy. There is a wooden door leading out.

You can see the child's bed (under the covers of which is a sleeping young boy), a lamp and a closet here.

The teddy bear waddles in from the Landing. The teddy bear whispers "It's worth giving a little thought to rule #2: make sure to take your time".

>leave
You shimmer through to the Landing.

Landing
A framed family photo hangs on the wall. A wooden door leads back in to the child's bedroom. The hallway itself continues south from here and while there is a staircase leading down to the first floor, all the fun is up here.

You can see a ball here.

The teddy bear waddles in from the Child's Bedroom.

* * *

>go in
You shimmer through to the Child's Bedroom.

Child's Bedroom
A typical kid's bedroom - all bright colours and optimism. You'd spit if you could. A small window paints a trapeziod of light over the young boy. There is a wooden door leading out.

You can see the child's bed (under the covers of which is a sleeping young boy), a teddy bear with a bored look on his face, a lamp and a closet here.

"Psst! It's me" hisses your plush companion.

>scenes
Scene 'Entire Game' playing (for 1 mins now)
Scene 'Sound Asleep' playing (for 1 mins now)
Scene 'Finding Teddy' ended
(Scene monitoring now switched on. Type "scenes off" to switch it off again.)

>look
Child's Bedroom
A typical kid's bedroom - all bright colours and optimism. You'd spit if you could. A small window paints a trapeziod of light over the young boy. There is a wooden door leading out.

You can see the child's bed (under the covers of which is a sleeping young boy), a teddy bear with a bored look on his face, a lamp and a closet here.

>x teddy
A more experienced buddy of yours, who kindly offered to come along and help you on your first haunt. He's standing on one leg.

>x teddy
A more experienced buddy of yours, who kindly offered to come along and help you on your first haunt. He's waiting to see what you'll do next.

>x teddy
A more experienced buddy of yours, who kindly offered to come along and help you on your first haunt. He's standing on one leg.

* * *

>x teddy
A more experienced buddy of yours, who kindly offered to come along and help you on your first haunt. He's waiting to see what you'll do next.

>x teddy
A more experienced buddy of yours, who kindly offered to come along and help you on your first haunt. He's standing on one leg.

The teddy bear whispers "Don't forget rule #1: always consider your surroundings".

>x teddy
A more experienced buddy of yours, who kindly offered to come along and help you on your first haunt. He's looking at his paws.

The teddy bear whispers "It's worth giving a little thought to rule #3: variety is vital to a good haunt".

>haunt bed
As you haunt the child's bed, it starts to shake back and forth.

The young boy wakes up not quite sure of what's going on. [Scene 'Sound Asleep' ends]
[Scene 'Paranormal Activity' begins]
The teddy bear immediately drops to the floor to evade suspicion. 

[Your score has just gone up by one point.]

>x teddy
A more experienced buddy of yours, who kindly offered to come along and help you on your first haunt. currently playing dead to avoid suspicion.

* * *

>x teddy
"Psst! It's me." hisses your plush companion.

.A more experienced buddy of yours, who kindly offered to come along and help you on your first haunt. He's looking at his paws.

>look
Child's Bedroom
A typical kid's bedroom - all bright colours and optimism. You'd spit if you could. A small window paints a trapeziod of light over the young boy. There is a wooden door leading out.

You can see the child's bed (under the covers of which is a sleeping young boy), a teddy bear with a bored look on his face, a lamp and a closet here.

>x teddy
.A more experienced buddy of yours, who kindly offered to come along and help you on your first haunt. He's standing on one leg.

* * *

>scenes
Scene 'Entire Game' playing (for 0 mins now)
Scene 'Sound Asleep' playing (for 0 mins now)
Scene 'Finding Teddy' playing (for 0 mins now)
(Scene monitoring now switched on. Type "scenes off" to switch it off again.)

>out
You shimmer through to the Hallway.

Hallway
A mirror hangs on the wall here. "How incredibly vain the living are" you ponder for a few moments. A bedroom door leads back in to the master bedroom. The landing lies to the north.

You can see a pedestal (on which is a radio) here.

>z
Time passes.

>n
You shimmer through to the Landing.

Landing
A framed family photo hangs on the wall. "The illusion of permanence" you think to yourself. A wooden door leads in to the child's bedroom. The hallway itself continues south from here and while there is a staircase leading down to the first floor, all the fun (read horror) is up here.

You can see a ball here.

>in
You shimmer through to the Child's Bedroom.

Child's Bedroom
A typical kid's bedroom - all bright colours and optimism. You'd spit if you could. A small window paints a trapeziod of light over the young boy. There is a wooden door leading out.

You can see the child's bed (under the covers of which is a sleeping young boy), a teddy bear with a bored look on his face, a lamp and a closet here.

[Scene 'Finding Teddy' ends]
"Psst! It's me" hisses your plush companion.

>x teddy
"Psst! It's me" hisses your plush companion.

A more experienced buddy of yours, who kindly offered to come along and help you on your first haunt. He's standing on one leg.

>l
Child's Bedroom
A typical kid's bedroom - all bright colours and optimism. You'd spit if you could. A small window paints a trapeziod of light over the young boy. There is a wooden door leading out.

You can see the child's bed (under the covers of which is a sleeping young boy), a teddy bear with a bored look on his face, a lamp and a closet here.

>x teddy
A more experienced buddy of yours, who kindly offered to come along and help you on your first haunt. He's waiting to see what you'll do next.